Mdd, Mdd, Mdd, Dd, Dd, Dd, Dd, Ds, Hd, Hd, Hd, Dd, Dd, Dd, Dd, Dd, Dd, Dd, Dd, Wwt, Wwt, Wwt, Ds, Dd, Dd, Dd, Dd^Esd, Dd, Hd, Dd, Dd, Dd, Dd, Dd^Esd, Dd, Dd, Dd, Dd, Dd, Dd^Edb, Hd, Hd, Hd, Hd, Hd, Dd
Mdd, Mdd, Mdd, Mdd, Hd, Hd, Dd, Dd, Dd, Dd, Dd, Dd, Dd, Dd, Dd^Edb, Dd, Dd, Dd, Rp^Vhcr, Wwrt, Wwt, Wwt, Ds, Ds, Dd, Dd, Dd^Edp, Hd, Hd, Dd, Dd, Dd, Dd^Edb, Dd, Dd, Dd, Dd, Dd, Hd, Dd, Hd, Hd, Hd, Dd, Dd, Dd
Mdd, Mdd, Mdd, Mdd, Hd, Dd, Dd, Dd, Mdd, Dd^Esd, Hd, Dd, Dd, Dd^Edb, Dd, Dd, Dd, Dd^Es, Dd^Es, Dd, Wwt, Wwt, Wwrt, Ds, Dd, Hd, Hd, Hd, Dd, Hd, Dd, Dd^Edb, Dd, Dd, Hd, Dd, Dd^Edb, Dd, Dd, Hd, Hd, Dd, Dd, Dd, Hd, Dd
Hd, Mdd, Hd, Hd, Dd, Dd^Edp, Dd, Hd, Dd, Mdd, Hd, Dd, Dd^Es, Dd, Dd, Dd^Edpp, Dd^Dc, Dd, Dd, Dd, Ds, Wwt, Wwt, Dd, Dd, Hd, Dd^Es, Dd, Dd^Edb, Dd, Dd, Dd^Dc, Dd, Hd, Hd, Dd^Edpp, Dd^Edb, Dd^Edb, Dd, Hd, Dd, Dd, Dd, Hd, Hd, Hd
Hd, Hd, Hd, Dd, Hd, Dd, Dd, Dd^Vhcr, Dd^Es, Dd, Dd, Dd, Dd^Es, Dd^Vhcr, Dd^Es, Dd, Dd, Dd, Dd, Dd, Ds, Wwt, Wwt, Ds, Ds, Dd, Dd, Dd^Vhcr, Dd^Es, Dd, Dd^Edb, Dd, Dd, Dd, Dd, Dd, Dd, Dd^Es, Rp^Vhcr, Dd, Dd, Dd, Dd, Hd, Hd, Dd
Dd, Dd, Hd, Hd, Mdd, Mdd, Hd, Dd, Dd, Dd^Edb, Dd, Dd, Dd, Rr^Esd, Dd, Dd^Edb, Dd^Edb, Dd, Dd, Dd, Rr^Esd, Ds, Wwt, Wwt, Ds, Dd, Dd, Dd^Es, Dd, Dd, Dd, Dd, Dd, Dd, Dd, Dd, Rr^Esd, Dd^Es, Dd, Dd, Dd, Dd, Dd^Dc, Dd, Dd, Dd
Dd, Dd, Dd, Dd, Mdd, Mdd, Hd, Hd, Dd, Dd, Dd^Edb, Dd, Dd, Dd, Dd, Dd^Edb, Dd, Dd, Dd^Vhcr, Dd^Es, Ds, Wwt^Bsb\, Wwrt^Es, Wwt, Dd, Dd, Dd, Dd, Rr^Esd, Rr^Esd, Dd, Dd^Es, Dd^Vhcr, Dd^Edb, Dd, Dd, Dd, Dd, Dd, Dd, Hd, Hd, Hd, Dd, Dd, Dd
Dd, Dd, Dd, Dd, Dd, Hd, Dd, Dd, Dd, Dd, Dd^Esd, Dd^Esd, Dd^Edpp, Dd, Dd, Dd, Dd, Dd, Dd, Dd^Es, Ds, Wwt, Wwt, Wwg^Bsb\, Rr^Esd, Dd, Dd, Dd, Dd, Rr^Esd, Dd, Dd^Es, Dd, Dd^Es, Dd, Dd, Dd, Dd, Dd, Dd, Hd, Hd, Dd, Dd, Dd, Dd
Dd, Dd, Dd, Dd, Dd, Dd, Dd, Dd, Hd, Dd, Mdd, Dd^Esd, Dd, Dd, Dd, Dd, Hd, Dd, Dd, Dd, Wwrt, Wwt, Wwt, Ds, Ds, Dd^Edb, Dd^Edb, Dd, Dd^Es, Dd, Dd, Dd, Dd, Dd, Dd, Dd, Hd, Hd, Dd, Dd, Dd, Hd, Dd, Dd, Dd, Dd
Rd, Dd, Dd, Dd, Dd, Dd, Dd, Hd, Dd^Edt, Dd, Dd, Dd, Dd, Dd, Dd, Dd, Dd^Edpp, Dd, Dd, Hd, Dd, Dd, Wwt, Wwt, Ds, Dd^Edb, Dd, Dd^Vhcr, Dd^Es, Dd^Edb, Dd, Dd, Dd^Dc, Dd, Dd, Dd, Hd, Hd, Dd, Dd, Dd, Dd, Dd, Dd, Rd, Rd
Rd, Rd, Rd, Dd, Dd, Dd, Dd, Dd^Edt, Dd, Dd^Edt, Rd^Edt, Cer, Cer, Dd, Hd, Hd, Dd, Dd^Dc, Hd, Hd, Ds, Ds, Wwt, Wwt, Wwrt, Dd, Dd, Dd, Dd, Dd, Dd, Dd, Dd, Dd, Dd, Dd, Dd, Dd, Dd, Dd, Dd, Dd, Dd, Rd, Dd, Dd
Dd, Dd, Rd, Dd, Dd, Dd^Vdt, Rd, Rd, Rd, Dd^Edt, Rd, Cer, Dd^Edt, Dd, Dd, Dd, Dd, Dd, Dd, Dd, Ds, Ds, Wwt, Wwt, Ds, Ds, Dd, Dd, Dd, Dd, Dd, Dd, Dd, Dd, Dd, Dd, Dd, Dd, Dd, Dd, Dd, Dd, Rd, Rd, Dd, Dd^Edp
Dd, Dd, Rd^Edt, Rd^Vct, Rd, Re, Cer, Cer, Cer, Re^Ecf, Dd, Rd, Dd^Edt, Dd^Edt, Dd, Dd, Dd, Dd, Dd, Dd, Wwrt, Wwt, Wwt, Wwt, Wwrt, Dd, Dd, Dd, Dd, Dd, Dd, Dd, Hd, Hd, Hd, Hd, Dd, Dd, Dd, Dd, Dd, Rd, Dd, Dd, Hd, Dd
Dd, Dd, Dd^Edt, Rd^Edt, Dd^Vdt, Re, Cer, 4 Ke, Cer, Re, Dd, Dd, Dd, Dd, Dd, Dd, Dd, Dd, Dd, Wwrt, Wwg, Wwg, Wwg, Wwg, Wwg, Wwrt, Ds, Dd, Dd, Hd, Dd, Dd, Dd, Dd, Dd, Dd, Dd, Dd, 3 Rd, Rd, Rd, Rd, Dd, Dd, Hd, Hd
Hd, Hd, Dd, Dd, Dd, Rd, Rd^Edt, Cer, Re, Re^Ecf, Re, Dd, Rd, Dd, Rd, Dd, Rd, Rd^Esd, Wwrt, Wwg, Ds^Es, Ds^Es, Ds^Es, Ds^Es, Ds^Es, Wwg, Wwrt, Rd, Rd, Dd, Rd, Dd, Dd, Dd, Dd^Edp, Dd, Dd, Dd, Rd, Dd, Dd, Dd, Dd, Dd, Dd, Dd
Dd, Dd, Dd^Edpp, Dd, Dd, Dd^Edt, Dd^Edt, Re^Ecf, Rd, Re, Dd^Edt, Rd, Rd^Esd, Rd, Rd^Esd, Rd, Rd, Rd, Wwrt, Wwg, Ds^Es, Ds^Es, Ds^Es, Ds^Es, Ds^Es, Wwg, Wwrt, Rd, Dd^Edpp, Rd, Rd, Rd, Rd, Dd, Rd, Dd, Rd, Rd, Rd^Esd, Dd, Dd^Es, Dd^Esd, Dd, Dd, Dd, Dd^Edpp
Dd, Dd, Dd, Dd, Dd, Dd, Dd^Edt, Dd^Edt, Cer, Cer, Dd^Edt, Dd^Edt, Dd, Dd, Dd, Dd, Dd, Ds, Ds, Wwg, Wwg, Ds^Es, Wwg, Ds^Es, Wwg, Wwg, Ds, Dd, Dd, Dd, Dd, Rd, Dd, Rd, Rd^Esd, Rd, Dd, Rd, Dd, Dd, Dd, Dd, Dd, Dd, Dd, Dd
Dd, Dd, Dd, Dd, Dd, Dd, Dd, Dd, Dd, Cer, Dd, Dd, Dd, Dd, Dd, Dd, Dd, Ds, Ds, Wwrt, Wwrt, Wwg, Wwt, Wwg, Wwrt, Wwrt, Ds, Ds, Dd, Dd, Dd, Dd, Dd, Dd, Dd, Dd, Dd, Dd, Dd, Dd, Dd, Dd, Dd, Dd, Hd, Dd
Dd, Dd, Dd, Dd, Dd, Dd, Dd, Dd, Dd, Dd, Dd, Dd, Dd, Dd, Dd, Dd, Dd, Dd, Dd, Dd, Dd, Wwt, Wwt, Wwt, Gd, Dd, Dd, Ds, Dd, Dd, Ds, Dd, Dd, Dd, Dd, Dd^Edp, Dd, Dd, Dd, Dd, Dd, Dd, Dd, Dd, Hd, Hd
Hd, Hd, Hd, Hd, Hd, Dd, Dd, Dd, Dd, Dd, Dd, Dd, Dd, Dd, Dd, Dd^Do, Dd, Dd, Ds, Dd, Ds, Wwf, Wwf, Wwrt, Gd, Dd, Dd, Dd, Dd, Dd^Do, Ds, Ds, Ds, Ds, Dd, Dd, Dd, Dd, Dd^Edpp, Dd, Hd, Hd, Dd, Dd, Dd, Dd
Hd, Hd, Dd, Dd, Dd, Dd, Dd, Dd, Dd, Dd, Gd, Wwt, Wwt, Dd, Dd, Dd, Dd, Dd, Dd, Ds, Wwrt, Wwt, Wwf, Gd, Dd, Dd, Dd, Dd, Dd, Ds, Ds, Ds, Wwt, Ds, Gd, Dd^Esd, Dd, Dd, Dd, Dd, Hd, Hd, Dd, Dd, Dd^Edpp, Dd
Hd, Hd, Dd, Dd, Dd, Dd, Dd, Dd, Dd, Dd, Wwt, Wwt, Gd, Dd, Dd, Dd, Dd, Dd, Dd, Ds, Gd, Wwf, Wwt, Dd, Dd, Dd, Dd, Dd, Dd, Ds, Dd, Ds, Ds, Wwt, Wwt, Wwt, Gd, Dd, Dd, Dd, Dd, Dd, Dd, Dd, Hd, Hd
Dd, Dd, Dd, Dd, Dd, Dd, Dd, Dd, Dd, Wwt, Gd, Wwt, Dd, Dd, Dd, Dd, Dd, Dd, Dd, Dd, Gd, Wwt, Wwt, Wwt, Ds, Dd, Dd, Dd, Dd, Dd, Dd^Edp, Dd, Gd, Wwt, Dd, Wwt, Gd, Dd, Dd, Dd, Dd, Dd, Dd, Dd, Dd, Hd
Dd, Dd, Dd, Dd, Dd, Dd, Dd, Dd, Dd^Vdt, Gd, Dd, Dd, Dd, Dd, Dd, Dd^Vdt, Dd, Dd, Dd, Dd, Dd, Wwrt, Wwt, Wwt, Wwrt, Ds, Dd, Dd, Dd, Dd, Dd^Vdt, Dd, Dd, Dd, Dd, Dd, Dd, Dd^Vdt, Dd, Dd, Hd, Hd, Dd, Dd, Dd, Dd
Dd, Hd, Hd, Hd, Dd, Dd, Dd, Dd, Dd, Dd, Dd, Dd, Dd, Dd, Dd, Dd, Dd, Dd, Dd, Dd, Dd, Ds, Wwt, Wwt, Ds, Ds, Ds, Dd, Dd, Dd, Dd, Dd, Dd, Dd, Dd, Dd, Dd, Dd, Dd, Dd, Hd, Hd, Hd, Hd, Dd, Dd
Hd, Hd, Hd, Dd, Dd, Dd, Dd, Dd, Dd, Dd, Dd, Dd, Dd, Dd^Edp, Dd, Dd, Dd, Dd, Dd, Dd, Chw, Wwt, Wwt, Wwt, Chw, Dd, Dd, Dd, Dd, Dd, Dd, Hd, Dd, Dd, Dd, Dd, Dd, Dd, Dd, Dd, Dd, Dd, Hd, Hd, Dd, Dd
Dd, Hd, Dd, Dd^Esd, Dd^Edpp, Dd, Hd, Hd, Dd, Dd, Dd, Dd, Dd, Dd, Hd, Dd, Dd, Dd, Dd, Chw, Chw, 1 Khw, Wwt, 2 Khw, Chw, Chw, Dd, Dd, Dd, Dd, Hd, Hd, Dd, Dd, Dd, Dd, Dd, Dd, Dd, Dd, Dd^Edp, Hd, Dd, Hd, Dd, Dd
Dd, Dd, Dd, Dd, Dd, Dd, Hd, Hd, Dd, Dd, Dd, Dd^Esd, Dd, Hd, Dd, Dd, Dd, Dd, Dd, Gd, Gd^Fts, Wwt, Wwt, Wwt, Gd^Fts, Gd, Dd, Dd, Dd, Dd, Dd, Dd, Dd, Dd, Hd, Dd, Hd, Dd, Dd, Dd, Dd, Dd, Dd, Dd, Dd, Dd
Dd, Dd, Dd, Dd, Dd, Dd, Dd, Dd, Dd, Dd, Dd, Dd, Dd, Dd, Dd, Dd, Dd, Dd, Gd, Gd^Fts, Ww^Vm, Wwt, Wwt^Ewf, Wwt, Ww^Vm, Gd^Fts, Gd, Dd, Dd, Dd, Dd, Dd, Dd, Hd, Dd, Hd, Dd, Dd, Dd, Dd, Hd, Hd, Dd, Dd, Hd, Hd
Dd, Dd, Dd, Hd, Dd^Edp, Dd, Dd, Dd, Dd, Dd, Hd, Dd, Hd, Dd, Dd, Dd, Dd, Dd, Gd, Gd^Fts, Gd^Fts, Wwt, Wwt, Wwt, Gd^Fts, Gd^Fts, Gd, Dd, Dd, Dd, Dd, Dd, Dd, Dd, Dd, Dd, Dd, Dd, Dd, Hd, Hd, Hd, Hd, Dd, Dd, Dd
Hd, Hd, Hd, Hd, Hd, Dd, Dd, Dd^Edpp, Dd, Dd, Hd, Hd, Hd, Dd, Dd, Dd, Dd, Dd, Dd, Dd, Gd, Wwt, Wwt, Wwt, Wwt, Ds, Ds, Dd, Dd, Dd, Dd, Dd, Hd, Hd, Hd, Hd, Dd, Dd, Dd^Esd, Dd, Dd, Dd, Dd, Dd, Dd, Dd
Hd, Hd, Dd, Hd, Dd^Edp, Dd, Dd, Dd, Dd, Hd, Hd, Hd, Dd, Hd, Dd, Dd, Dd, Dd, Dd, Dd, Dd^Esd, Gd, Wwt, Wwt, Ww, Ds, Dd, Dd, Dd, Dd, Dd, Dd, Hd, Hd, Dd, Hd, Dd, Dd, Dd, Dd^Edp, Dd, Dd, Dd, Dd, Dd, Dd
