Rd, Rd, Gg, Gg, Gg, Gg, Gg, Gg, Gg, Gg, Gg, Gg, Gg, Hh, Hh, Hh, Hh, Gg, Gs^Fds, Gs^Fds, Hh^Fms, Hh^Fms, Gs^Fms, Gs^Fds, Gs^Fds, Gs^Fds, Hh^Fds, Hh^Fds, Gs^Fds, Gs^Fds, Gs^Fms, Gs^Fds, Gs^Fds, Gs^Fds, Gll^Fmw, Gll^Fmw, Gll^Fmw, Gll^Fmw, Gll^Fdw, Gll^Fmw, Gll^Fmw, Gll^Fmw
Rd, Rd, Gg, Gg, Gg, Gg, Gg, Gg, Gs, Gg, Rd, Gg, Hh, Hh, Hh, Hh, Hh^Fds, Hh^Fds, Gs^Fds, Hh^Fds, Hh^Fms, Hh^Fms, Hh^Fds, Gs^Fds, Hh^Fds, Hh^Fds, Hh^Fms, Hh^Fds, Gs^Fms, Gs^Fms, Gs^Fms, Gs^Fds, Gll^Fmw, Gll^Fmw, Gll^Fmw, Gll^Fmw, Hh, Gll^Fmw, Gll^Fmw, Gll^Fdw, Gll^Fdw, Gll^Fmw
Rd, Rd, Rd, Rd, Gg, Gg, Gg, Gg, Gs, Gs, Rd, Hh, Hh, Hh, Hh, Hh, Hh, Hh^Fds, Hh^Fds, Gs^Fds, Hh^Fds, Hh^Fms, Hh^Fds, Hh^Fds, Hh^Fds, Hh^Fds, Gs^Fms, Gs^Fms, Hh^Fds, Hh^Fds, Hh^Fds, Hh^Fds, Gs^Fds, Gs^Fds, Hh, Hh, Hh, Hh^Fds, Gll^Fmw, Gll^Fmw, Gll^Fdw, Gll^Fmw
Hh, Rd, Rd, Rd, Gg, Gg, Gg, Gs, Gs, Rd, Gs, Rd, Hh, Hh, Hh, Hh, Hh, Hh, Hh, Gs, Gs^Fds, Hh^Fds, Gs^Fds, Hh^Fds, Hh^Fds, Gs^Fms, Gll^Fp, Gs^Fds, Hh^Fms, Hh^Fms, Hh^Fms, Hh^Fds, Gs^Fds, Gs^Fds, Hh, Hh, Hh, Hh^Fds, Gs^Fms, Gll^Fmw, Gll^Fmw, Gll^Fdw
Hh, Gg, Gg, Gg, Gg, Gg, Gg, Gs, Gs, Gs, Gs, Rd, Hh, Gg, Gg, Gg, Hh, Gs, Gs, Gs, Gs^Fds, Gs^Fds, Gs^Fds, Gs^Fds, Gs^Fds, Gs^Fds, Gll^Fp, Gll^Fp, Hh^Fms, Hh^Fms, Gs^Fds, Gs^Fds, Gs^Fds, Gs^Fds, Gg, Gg, Hh, Hh, Hh^Fds, Gll^Fmw, Gll^Fdw, Gll^Fmw
Hh, Hh, Gg, Gg, Gg, Gg, Gg, Gg, Gg, Gg, Gg, Gg, Gg, Gg, Gg, Gg, Gs, Gs, Gs, Gs^Fds, Gs^Fds, Gs^Fds, Gs^Fds, Gll^Fp, Gll^Fp, Gll^Fp, Hh^Fds, Gs^Fds, Gs^Fms, Gs^Fds, Gg, Gg, Gg, Gg, Gg, Gg, Hh, Hh, Gs^Fms, Gll^Fmw, Gll^Fmw, Gll^Fmw
Hh, Hh, Hh, Gg, Gg, Gg, Rd, Gg, Rd, Gg, Gg, Gg, Gg, Gg, Gg, Gg, Gg, Gs, Hh, Hh, Hh, Hh^Fds, Hh, Gs^Fds, Gs^Fds, Hh^Fds, Hh^Fms, Hh^Fms, Gs^Fds, Gg, Gs, Gs^Fds, Gs^Fds, Gs^Fds, Gg, Gs^Fds, Gs^Fds, Gs^Fds, Gs^Fms, Gs^Fms, Gll^Fp, Gll^Fmw
Hh, Hh, Gs, Gg, Gg, Gg, Gg, Rd, Rd, Gs, Gg, Gg, Gg, Gg, Gs^Vc, Gg, Gg, Gg^Fp, Gll^Fp, Gll^Fp, Hh^Fp, Hh, Hh, Hh, Hh, Gs^Fds, Gs^Fds, Gs^Fds, Gs^Fds, Gg, Gg, Gs^Fds, Gs^Fds, Gg, Gs, Gs^Fds, Gg, Gs^Fds, Gg, Gs^Fds, Gll^Fp, Gs^Fds
Hh, Gs, Gs, Gs^Vc, Gg, Gs, Gg, Rd, Rd, Gs, Gs, Gs, Gg, Gg, Gg, Gg, Gll^Fp, Gll^Fp, Gll^Fp, Gll^Fmw, Hh^Fp, Hh, Hh, Gg, Gg, Gg, Gg, Gg, Gg, Gs, Gs, Gg, Gg, Gg, Gs, Gs, Gs, Gg, Gll^Fp, Gs^Fms, Gs^Fds, Gs^Fds
Hh, Gg, Gg, Gg, Gg, Gg, Gg, Rd, Gs, Gs, Gs, Gg, Gg, Gg, Gg, Gg, Gg, Gll^Fmw, Gg, Gll^Fmw, Hh^Fp, Hh, Gll^Fp, Hh, Ds, Ww, Ds, Gg, Ww, Gg, Gg, Gg, Gs^Fds, Gg, Gg, Gg, Gg, Gg, Gll^Fp, Gs^Fds, Gll^Fp, Gll^Fp
Gg, Gg, Gg, Gg, Re^Edt, Re^Edt, Gg, Gg, Gg, Gg, Gg, Gg, Gg, Gg, Gg, Gg, Gg, Gll^Fp, Gll^Fp, Gg, Gg, Gll^Fp, Gll^Fmw, Gg, Ds, Ww, Wo, Ww, Ww, Ww, Gg, Gs^Fds, Gs^Fds, Gg, Gg, Gg, Gg, Gll^Fp, Gll^Fp, Gll^Fp, Gll^Fp, Gll^Fp
Gg, Gg, Gg, Gg, Rb, Re^Edt, Gg, Gg, Gg, Gg, Gg, Gs, Gs^Edt, Gs, Gs, Gg, Gg, Gll^Fp, Gg, Gll^Fp, Gg, Gll^Fp, Gg, Gg, Ww, Ww, Wo, Wo, Ds, Ds, Gs^Fms, Gs^Fds, Gll^Fp, Gs^Fds, Gs^Fms, Gs^Fds, Gs^Fds, Gll^Fp, Gll^Fp, Gll^Fp, Gll^Fp, Gll^Fp
Gs^Fms, Gg, Gg, Re^Edt, Gg, Gg, Gg, Gg, Gll^Fdw, Gg, Gg, Gg, Re^Edt, Gs, Gg, Gs, Gg, Gg, Gg, Gg, Gg, Gll^Fp, Gg, Gg, Ww, Wo, Ww, Ww, Gg, Gs^Fds, Gs^Fds, Gs^Fms, Gll^Fp, Gll^Fp, Gll^Fp, Gs^Fms, Gs^Fms, Gs^Fds, Gs^Fds, Gll^Fp, Gs^Fms, Gll^Fp
Gs^Fms, Gs^Fms, Gg, Gs^Fms, Gs^Fms, Gs^Fms, Gg, Gg, Gll^Fdw, Gll^Fmw, Gg, Rb, Re^Edt, Re^Edt, Gs, Gg, Gg, Gg, Gg, Gg, Gg, Gg, Gg, Gs, Gs, Gs, Ww, Gg, Gs^Fds, Gg, Gs^Fms, Gs^Fms, Gs^Fds, Gs^Fds, Gs^Fds, Gs^Fds, Gs^Fds, Gs^Fms, Gs^Fms, Gs^Fms, Gs^Fms, Gll^Fp
Gs^Fms, Gs^Fms, Gll^Fdw, Gs^Fms, Gll^Fdw, Gs^Fms, Gll^Fdw, Gg, Gg, Gll^Fdw, Gg, Gs, Gll, Gg, Gg, Gs, Gg, Gg, Gg, Gg, Gg, Gg, Gs, Gs^Edt, Gs^Edt, Gs, Gg, Gg, Gs^Fds, Gs^Fds, Gs^Fms, Gs^Fms, Gs^Fms, Gg, Gg, Gs^Fds, Gg, Gs^Fds, Gs^Fms, Gs^Fms, Gs^Fms, Gs^Fds
Gll^Fdw, Gs^Fms, Gs^Fms, Gll^Fdw, Gll^Fmw, Gll^Fdw, Gll^Fmw, Gll^Fdw, Gll^Em, Gg, Gll^Fdw, Gll, Gll^Fdw, Gg, Gg, Gg, Gg, Gg, Chr, Chr, Chr^Edb, Gg, Re, Gs^Edt, Gs^Edt, Gs, Gs, Gs, Gs^Fms, Gs^Fds, Gs^Fds, Gs^Fds, Gs^Fds, Gg, Gg, Gg, Gs^Fds, Gg, Gs^Fds, Gll^Fp, Gll^Fp, Gs^Fms
Gll^Fdw, Gs^Fms, Gll^Fdw, Ss, Ss, Ss, Gll, Gll, Gg, Gll, Gll^Fdw, Gll^Fmw, Gll^Fmw, Gll^Fdw, Gg, Gg, Gg, Gg, Chr, Khr, Chr^Edb, Re, Re, Rb, Gs^Edt, Gs^Edt, Gg, Gs^Fds, Gg, Gs^Fds, Gg, Gg, Gg, Gg, Gg, Gs^Fds, Gs^Fds, Gg, Gs^Fds, Gll^Fp, Gll^Fp, Gll^Fp
Ss, Gll^Fdw, Gll, Ss, Gll^Em, Ss, Gll, Ss, Gll, Gg, Gll, Gll, Gll^Fdw, Gll, Gg, Gg, Gg, Re, Re, Chr, Khr, Chr, Gg, Re, Gs, Gg, Gg, Gg, Gg, Gg, Gg, Gg, Gg, Gg, Gg, Gg, Gg, Gs^Fds, Gs^Fds, Gs^Fms, Gll^Fp, Gll^Fp
Gll^Fdw, Gll^Fmw, Ss, Gll^Em, Gll, Gll^Em, Gll, Gll, Rb, Gg, Gll, Ss, Gll, Gll^Fdw, Gg, Rb, Re, Re, Re, Chr, Chr, Chr^Edb, Gg, Gg, Gg, Gg, Gg, Gg, Gg, Gg, Gg, Gs^Fds, Gs^Fms, Gs^Fds, Gg, Gg, Gg, Gs^Fds, Gs^Fds, Gs^Fms, Gs^Fms, Gs^Fds
Gll^Fdw, Ss, Ss, Ss, Gll, Gll, Ss, Gll, Gll, Gll, Ss, Ss, Gll, Gg, Gg, Gg, Re, Gg, Gg, Gg, Gg, Gg, Gg, Gg, Gg, Gg, Gs, Gg, Gg, Gg, Gs^Fds, Gs^Fms, Gs^Fms, Gg, Gg, Gg, Gg, Gg, Gg, Gs^Fms, Gg, Gg
Ww, Ww, Ww, Ww, Ww, Gll, Ss, Ss, Ss, Gg^Em, Gll, Ss, Ss, Gll, Gg, Gg, Re, Gg, Gg, Gg, Gg, Gg, Gg, Gg, Gs, Gs^Fds, Gs, Gg, Gg, Gg, Gg^Edt, Rb, Gs^Fds, Gs^Fds, Gg, Gg, Gg, Gg, Gg, Gg, Gg, Gg
Ss, Ss, Ss, Ww, Ss, Ww, Ww, Ss, Ss, Gll, Gll^Fdw, Gll^Fmw, Ss, Gg, Re, Re, Gg, Gg, Gg, Gg, Gg, Gg, Gg, Gs^Fds, Gs^Fds, Gs, Gs^Edt, Gs, Gs, Gs, Gs^Edt, Gg^Edt, Gg, Gg, Gg, Gg, Gg, Gg, Gg, Gg, Gg, Gg
Gg, Ss, Gg, Ss, Gg, Ss, Ww, Ss, Gg, Gll, Gg, Gll^Fdw, Gll^Fdw, Gg, Re, Gs^Edt, Gd^Vhr, Gg, Gg, Gg, Gg, Gg, Gg^Edt, Gg, Gg, Gg, Gs^Edt, Gs, Gg, Gs, Gg^Edt, Gg, Gll^Fp, Gg, Gs^Fds, Gg, Gg, Gg, Gg, Gg, Gg, Gg
Gs^Fds, Gg, Gs^Fds, Gg, Ss, Ss, Ww, Ss, Ds, Gg, Ds, Gg, Gg, Gg, Re, Gs, Gs^Edt, Gs^Edt, Gs, Gs, Gg, Gs^Edt, Gg^Edt, Rb, Gg, Gg^Edt, Gs^Edt, Gs, Gg, Gg, Gg, Gg, Gll^Fp, Gll^Fp, Gs^Fms, Gg, Rd, Rd, Gg, Gg, Gg, Gg
Gs^Fds, Gs^Fds, Gs^Fms, Gll, Gll, Ss, Ds, Ww, Ww, Ds, Ww, Ds, Gg, Gg, Re, Gs, Gs, Gs, Gs, Gs, Gg, Gg, Gs^Fds, Gg, Gg, Gs, Gs, Gg, Gg, Gg, Gs^Fds, Gs^Fds, Gs^Vc, Gll^Fp, Gs^Fms, Gs^Fds, Rd, Rd, Gg, Gg, Ww, Ww
Gs^Fds, Gll^Fp, Gg^Edt, Gs^Fds, Gll, Ss, Gll, Ds, Ss, Ww, Ss, Ww, Ww, Re, Ww, Ds, Ds, Ds, Gs, Gg, Gg, Gs^Fds, Gg, Gs^Fds, Gg, Gg, Gg, Gg, Gg, Gg, Gg, Gs^Fds, Gg, Gs^Fms, Gs^Fds, Rd, Rd, Ds, Ds, Ww, Wo, Ww
Gll, Gs^Fms, Gg^Edt, Gll, Gll^Em, Gll, Gll^Em, Gll, Gll, Ss, Gs^Fms, Gs^Fds, Gs^Fds, Ww^Es, Gll, Ww, Ww, Ds, Ds, Gg, Gg, Gg, Gg, Gg, Gg, Gg, Gg, Gg, Gg, Gg, Gg, Gg, Gg, Gs^Fds, Gg, Gg, Ds, Ds, Ww, Ww, Wo, Ww
Gll, Gll^Edt, Gg^Edt, Gll, Ss, Ss, Gll^Edt, Gll, Gs^Fds, Gll^Fp, Gs^Fms, Gg, Rb, Re, Gll^Edt, Ss, Ss, Ww, Ds, Gg, Gg, Gg, Gs, Gg, Gg, Gg, Gg, Gg, Gs^Fds, Gg, Gs^Fds, Gg, Gg, Gg, Rd, Gg, Ds, Ww, Wo, Wo, Ww, Ds
Gll, Rb, Gg, Gg, Gg, Gd^Vhr, Re^Edt, Gg, Gg, Gs^Fds, Gg, Gg, Re, Re, Gll^Edt, Gll, Ss, Ww, Ss, Gg, Gg, Gg, Gs, Gs, Gg, Gg, Gg, Gg, Gs^Fds, Gs^Fds, Gs^Fds, Gs^Fms, Gs^Fds, Gs^Fds, Rd, Ds, Ds, Ww, Wo, Ww, Ds, Ds
Gg, Gg, Gg, Gg, Gg, Re, Gg, Gs, Gs, Gg, Gs, Re, Gg, Gg^Edt, Gs^Fds, Gs^Fds, Gs^Fms, Ww, Ww, Ss, Ds, Gg, Gs, Gs, Gg, Gg, Gg, Gs^Fds, Gs^Fds, Gll^Fp, Gll^Fp, Gs^Fms, Gs^Fms, Rd, Gs^Fds, Rd, Ds, Ww, Ww, Wwr, Ds, Gg
Gs^Fds, Gg, Gg, Gg, Gg, Gg, Gs, Gs, Gs, Gs, Re, Re, Gll, Gll, Gs^Fds, Gll^Fp, Gll, Gs^Fds, Ss, Ww, Ds, Ds, Gs, Gs, Gs, Gs, Gg, Gs^Fds, Gs^Fds, Gs^Fds, Gll^Fp, Gs^Fms, Gll^Fp, Gs^Fms, Gs^Fds, Gs^Fds, Ww, Ww, Ww, Ds, Gg, Gg
Gs^Fms, Gg, Gs^Fds, Gg, Gg^Edt, Gg, Gs, Gs, Re, Re, Re^Edt, Gll^Edt, Ss, Gll, Gg, Gg, Gg^Edt, Gll, Gg, Ww, Ww, Ds, Ds, Gs, Gs, Gs, Gs, Gs^Vc, Gs^Fds, Gs^Fds, Gs^Fms, Gll^Fp, Gs^Fds, Gs^Fms, Gs^Fds, Gs^Fds, Wwr, Ww, Ww, Ds, Gg, Gg
Gs^Fds, Gs^Fms, Gs^Fds, Re, Re^Edt, Gg, Gg, Gg, Re, Gg, Gg, Gd^Vhr, Re^Edt, Gll, Gg, Gg, Re, Re^Edt, Gd^Vhr, Gg, Gg, Ww, Ww, Ds, Gs, Gs, Gs, Gs^Fds, Gs^Fds, Gs^Fms, Gs^Fms, Gs^Fms, Gs^Fms, Ds, Ds, Ds, Ww, Wo, Ww, Gg, Gs^Fds, Gs^Fds
Gs^Fds, Gs^Fds, Gs^Fds, Gd^Vhr, Gg, Gg, Gg, Re, Gg, Gg, Gg, Gg^Edt, Re, Gg, Gg, Re, Gg, Re^Edt, Gg, Gg, Gg, Ww, Ww, Ds, Ds, Gs, Ds, Gs, Gs^Fds, Gs^Fds, Gs^Fms, Gs^Fms, Ds, Ds, Ds, Ds, Wo, Wo, Gs^Fds, Gg, Gs^Fds, Gs^Fds
Gs^Fds, Gs^Fms, Gg, Gg, Gg, Gg, Gg, Re, Gg, Gg, Gg, Gg, Gg, Gg, Gs, Gg, Gs^Fds, Gg, Gs, Gs, Gg, Ww, Ww, Ds, Ds, Ds, Ww, Ds, Ww, Gs^Fds, Ww, Gs^Fds, Ww, Ww, Ww, Ww, Wo, Ww, Gs^Fds, Gs^Fds, Gs^Fds, Gs^Fds
Gs^Fms, Gs^Fds, Gs^Fds, Gg, Ce, Ce, Re^Edt, Re, Gs, Gg, Gg, Gg, Gg, Gg, Gg, Gg, Gg, Gs^Fms, Gs, Gs, Gs, Gg, Ww, Ww, Ds, Ds, Ww, Ww, Wo, Wo, Wo, Wo, Ww, Ww, Wwr, Wo, Gg, Gs^Fds, Gs^Vc, Gs^Fds, Gs^Fds, Gs^Fds
Gs^Fms, Gll^Fp, Gg, Gg, 1 Ke, Ce, Re^Ecf, Re^Edt, Ce, Gg, Gs, Gg, Gg, Gg, Re^Edt, Re^Edt, Gg, Gg, Gs, Gs, Gg, Gg, Ww, Ww, Ww, Ww, Ww, Wwr, Ds, Ww, Ds, Ww, Ds, Gg, Gg, Gg, Gg, Gs^Fds, Gg, Gs^Fds, Gg, Gs^Fds
Gs^Fds, Gs^Fms, Gg, Gg, Gg, Re^Edt, Re^Edt, Ce, Ce, Gs, Gs, Gg, Gg, Gg, Re, Gd^Vhr, Gs^Fds, Gs^Fds, Gs^Fds, Gs^Fds, Gg, Gg, Gg, Ww, Wo, Wo, Ww, Ds, Gg, Ds, Gg, Ds, Gg, Gg, Gg, Gg, Gg, Gg, Gg, Gg, Gg, Gg
Gg, Gg, Gg, Gg, Re, Re, Gs, 2 Ke, Gs, Gs, Gs, Gs, Gg, Gg, Gg, Gg, Gs^Fms, Gll^Fp, Gs^Fds, Gs, Gg, Gg, Ww, Ww, Wo, Wo, Ds, Ds, Gg, Gg, Gg, Gg, Gs^Fds, Gs^Fds, Gs^Fds, Gs^Fds, Gs^Fds, Gg, Gg, Gg, Gg, Gg
Gg, Gg, Gg, Gg, Re, Gs, Gg, Gs, Gs, Gs, Gs, Gs, Gs, Gg, Gg, Gs^Fds, Gs^Fms, Gs^Fms, Gg, Gg, Gg, Ww, Ww, Ww, Wo, Ww, Ds, Gg, Gg, Gg, Gg, Gs^Fds, Gg, Gs^Fds, Gs^Fds, Gs^Fds, Gs^Fds, Gg, Gg, Gg, Gg, Gg
