Gd, Aa, Aa, Aa, Aa, Aa, Aa, Aa, Aa, Gd, Gd, Gd
Aa, Gd, Aa, Aa, Aa, Aa, Aa, Aa, Gd, Gd, Gd, Gd
Aa, Aa, Aa, Aa, Chr^Esa, Chr^Esa, Chr^Esa, Aa, Re, Gd, Gd, Gd
Aa, Aa, Aa, Aa, Chr^Esa, Khr, Chr^Esa, Re, Re, Aa^Vha, Gd, Gd
Aa, Aa, Aa, Re, Re, Chr^Esa, Khr, Chr^Esa, Aa, Re, Gd, Aa
Aa, Aa^Vha, Re, Re, Re, Chr^Esa, Chr^Esa, Chr^Esa, Aa, Aa, Aa, Aa
Aa, Aa, Re, Aa, Aa, Gd^_ml, Aa, Aa, Aa, Aa, Aa, Aa
Aa, Aa, Re, Aa, Aa, Aa, Aa, Aa, Aa, Aa, Gd, Aa^Fda
Re, Re, Aa, Aa, Aa, Aa, Aa, Aa, Aa, Aa^Fda, Aa^Fda, Gd
