Dd, Dd, Dd, Dd, Dd, Dd, Dd, Dd, Dd, Dd, Dd, Rd, Dd, Hh, Hh, Hh, Hh, Gg, Gs^Fds, Gs^Fds, Hh^Fms, Hh^Fms, Gs^Fms, Gs^Fds, Gs^Fds, Gs^Fds, Hh^Fds, Hh^Fds, Gs^Fds, Gs^Fds, Gs^Fms, Gs^Fds, Gs^Fds, Gs^Fds, Gll^Fmw, Gll^Fmw, Gll^Fmw, Gll^Fmw, Gll^Fdw, Gll^Fmw, Gll^Fmw, Gll^Fmw
Dd, Dd, Dd, Dd, Dd, Dd, Dd, Dd, Rd, Dd, Gg, Rd, Rd, Dd, Hh, Hh, Hh^Fds, Hh^Fds, Gs^Fds, Hh^Fds, Hh^Fms, Hh^Fms, Hh^Fds, Gs^Fds, Hh^Fds, Hh^Fds, Hh^Fms, Hh^Fds, Gs^Fms, Gs^Fms, Gs^Fms, Gs^Fds, Gll^Fmw, Gll^Fmw, Gll^Fmw, Gll^Fmw, Hh, Gll^Fmw, Gll^Fmw, Gll^Fdw, Gll^Fdw, Gll^Fmw
Dd, Dd, Rd, Dd, Dd, Dd, Dd, Dd, Rd, Gg, Gg, Gg, Rd, Gs, Gs, Hh, Hh, Hh^Fds, Hh^Fds, Gs^Fds, Hh^Fds, Hh^Fms, Hh^Fds, Hh^Fds, Hh^Fds, Hh^Fds, Gs^Fms, Gs^Fms, Hh^Fds, Hh^Fds, Hh^Fds, Hh^Fds, Gs^Fds, Gs^Fds, Hh, Hh, Hh, Hh^Fds, Gll^Fmw, Gll^Fmw, Gll^Fdw, Gll^Fmw
Ds, Gg, Rd, Dd, Gg, Ds, Ds, Dd, Ds, Rd, Gg, Gg, Rd, Gs, Gs, Gs, Hh, Hh, Hh, Gs^Vc, Gs^Fds, Hh^Fds, Gs^Fds, Hh^Fds, Hh^Fds, Gs^Fms, Gll^Fp, Gs^Fds, Hh^Fms, Hh^Fms, Hh^Fms, Hh^Fds, Gs^Fds, Gs^Fds, Hh, Hh, Hh, Hh^Fds, Gs^Fms, Gll^Fmw, Gll^Fmw, Gll^Fdw
Ds, Ds, Gg, Rd, Gg, Ds, Ds, Ds, Gg, Gg, Ss^Qhu, Gg, Gg, Rd, Rd, Gs, Hh, Gs, Gs, Gs, Gs^Fds, Gs^Fds, Gs^Fds, Gs^Fds, Gs^Fds, Gs^Fds, Gll^Fp, Gll^Fp, Hh^Fms, Hh^Fms, Gs^Fds, Gs^Fds, Gs^Fds, Gs^Fds, Gg, Gs^Vl, Hh, Hh, Hh^Fds, Gll^Fmw, Gll^Fdw, Gll^Fmw
Gg, Ds, Gg, Gg, Gg, Gg, Ds, Ds, Gg, Gll, Ss^Qhu, Ss^Qhu, Gg, Gg, Rd, Gg, Gs, Gs, Gs, Gs^Fds, Gs^Fds, Gs^Fds, Gs^Fds, Gll^Fp, Gll^Fp, Gll^Fp, Hh^Fds, Gs^Fds, Gs^Fms, Gs^Fds, Gg, Gg, Gg, Gg, Gg, Gg, Hh, Hh, Gs^Fms, Gll^Fmw, Gll^Fmw, Gll^Fmw
Gg, Gg, Gg, Gg, Gg, Ds, Gg, Ds, Ds, Gll, Gll, Ss^Qhu, Ss^Qhu, Gg, Rd, Gg, Gg, Gs, Hh, Hh, Hh, Hh^Fds, Hh, Gs^Fds, Gs^Fds, Hh^Fds, Hh^Fms, Hh^Fms, Gs^Fds, Gs^Vl, Gs, Gs^Fds, Gs^Fds, Gs^Fds, Gg, Gs^Fds, Gs^Fds, Gs^Fds, Gs^Fms, Gs^Fms, Gll^Fp, Gll^Fmw
Ds, Gg, Ds, Ds, Ds, Rd, Gg, Ds, Gg, Gll, Ss^Qhu, Ss^Qhu, Ss^Qhu, Gg, Rd, Gg, Gg, Gg^Fp, Gll^Fp, Gll^Fp, Hh^Fp, Hh, Hh, Hh, Hh, Gs^Fds, Gs^Fds, Gs^Fds, Gs^Fds, Gg, Gg, Gs^Fds, Gs^Fds, Gg, Gs, Gs^Fds, Gg, Gs^Fds, Gg, Gs^Fds, Gll^Fp, Gs^Fds
Ds, Ds, Ss^Qhu, Ds, Ds, Rd, Rd, Gg, Gg, Ss^Qhu, Ss^Qhu, Ss^Qhu, Ss^Qhu, Gll, Gs, Rd, Gll^Fp, Gll^Fp, Gll^Fp, Gll^Fmw, Hh^Fp, Hh, Hh, Gg, Gg, Gg, Gg, Gg, Gg, Gs, Gs, Gg, Gg, Gg, Gs, Gs, Gs, Gg, Gll^Fp, Gs^Fms, Gs^Fds, Gs^Fds
Ss^Qhu, Ss^Qhu, Ss^Qhu, Ds, Ds, Ds, Rd, Gll, Gg, Ss^Qhu, Gg, Rd, Ss^Qhu, Gll, Gs, Rd, Rd, Gll^Fmw, Gll^Fp, Gll^Fmw, Hh^Fp, Hh, Gll^Fp, Hh, Ds, Ww, Ds, Gg, Ww, Gg, Gg, Gg, Gs^Fds, Gg, Gg, Gg, Gg, Gg, Gll^Fp, Gs^Fds, Gll^Fp, Gll^Fp
Ss^Qhu, Ss^Qhu, Ww^Qhu, Ss^Qhu, Ds, Ds, Gll, Gll, Gg, Gg, Gg, Rd, Rd, Gs, Gs, Gs, Rd, Gll^Fp, Gll^Fp, Gll^Fp, Gll^Fp, Gll^Fp, Gll^Fmw, Gg, Ds, Ww, Wo, Ww, Ww, Ww, Gg, Gs^Fds, Gs^Fds, Gg, Gg, Gs^Vl, Gg, Gll^Fp, Gll^Fp, Gll^Fp, Gll^Fp, Gll^Fp
Ss^Qhu, Ss^Qhu, Gll, Ww^Qhu, Ww^Qhu, Gll, Gll, Gll, Gll, Ds, Ds, Rd, Rd, Ds, Gs, Gs, Rd, Gll^Fp, Gg, Gll^Fp, Gg, Gll^Fp, Gg, Gg, Ww, Ww, Wo, Wo, Ds, Ds, Gs^Fms, Gs^Fds, Gll^Fp, Gs^Fds, Gs^Fms, Gs^Fds, Gs^Fds, Gll^Fp, Gll^Fp, Gll^Fp, Gll^Fp, Gll^Fp
Gll, Gll^Edt, Gll^Feth, Gll^Edt, Ww^Qhu, Ss^Qhu, Ss^Qhu, Ss^Qhu, Ss^Qhu, Ds, Ds, Ds, Ds, Ds, Gg, Gs, Gs, Rd, Gg, Gg, Gg, Gll^Fp, Gg, Gg, Ww, Wo, Ww, Ww, Gg, Gs^Fds, Gs^Fds, Gs^Fms, Gll^Fp, Gll^Fp, Gll^Fp, Gs^Fms, Gs^Fms, Gs^Fds, Gs^Fds, Gll^Fp, Gs^Fms, Gll^Fp
Ss^Qhu, Gll^Edt, Gll, Gll^Edt, Ss^Qhu, Ss^Qhu, Gll^Vhs, Gll^Qhu, Ww^Qhu, Ss^Qhu, Ds, Ds, Rd, Ds, Gg, Gs, Gs, Rd, Gg, Gg, Gg, Gs, Gs, Gs, Gs, Gs, Ww, Gg, Gs^Fds, Gg, Gs^Fms, Gs^Fms, Gs^Fds, Gs^Fds, Gs^Fds, Gs^Fds, Gs^Fds, Gs^Fms, Gs^Fms, Gs^Fms, Gs^Fms, Gll^Fp
Ss^Qhu, Gll, Gll, Gll, Gll, Gll, Gll, Ss^Qhu, Ww^Qhu, Ww^Qhu, Ds, Ds, Rd, Gg, Gg, Gs, Gg, Rd, Rd, Gg, Re^Edt, Gs^Edt, Gs, Gs, Gs, Gs, Gg, Gg, Gs^Fds, Gs^Fds, Gs^Fms, Gs^Fms, Gs^Fms, Gg, Gg, Gs^Fds, Gg, Gs^Fds, Gs^Fms, Gs^Fms, Gs^Fms, Gs^Fds
Ww^Qhu, Ww, Gll, Gll, Gll, Gll, Ss^Qhu, Ss^Qhu, Ss^Qhu, Ss^Qhu, Ss^Qhu, Rd, Rd, Gg, Gs, Gg, Gs^Edt, Re, Chr, Chr, Chr^Edb, Re^Edt, Gs, Gs, Gs, Gs, Gg, Gg, Gs^Fds, Gs^Fds, Gs^Fds, Gs^Fds, Gs^Fds, Gg, Gg, Gg, Gs^Fds, Gg, Gs^Fds, Gll^Fp, Gll^Fp, Gs^Fms
Ss^Qhu, Ww, Ss, Gll, Ww, Ww^Qhu, Ss^Qhu, Gll^Qhu, Gll, Gll, Gg, Gg, Gg, Gs, Rb, Gs^Edt, Re^Edt, Re, Chr, 3 Khr, Chr^Edb, Re^Edt, Re, Gs, Gs, Gg, Gg, Gs^Fds, Gg, Gs^Fds, Gg, Gg, Gg, Gg, Gg, Gs^Fds, Gs^Fds, Gg, Gs^Fds, Gll^Fp, Gll^Fp, Gll^Fp
Ss^Qhu, Ss^Qhu, Ss, Ss, Ww^Qhu, Ss^Qhu, Ss^Qhu, Gll^Qhu, Gll^Qhu, Gll, Gll^Qhu, Gll, Gll, Gs, Gg, Gs^Edt, Gs^Edt, Re, Re, Chr, Khr, Chr, Rd, Gs, Gs, Gg, Gs, Gg, Rd, Gg, Rd, Rd, Rd, Gg, Rd, Gg, Gg, Gs^Fds, Gs^Fds, Gs^Fds, Gll^Fp, Gll^Fp
Ss^Qhu, Gll, Gll, Ss, Gll, Ss^Qhu, Ss^Qhu, Gll^Qhu, Ss^Qhu, Gll^Qhu, Rd^Qhu, Ds^Qhu, Gg, Gg, Gg, Gs, Rd, Rd, Re^Edt, Chr, Chr, Chr^Edb, Gs, Rd, Rd, Rd, Rd, Rd, Rb, Rd, Gs^Fds, Gg, Gg, Rd, Gg, Rd, Rd, Gs^Fds, Gs^Fds, Gs^Fds, Gs^Fds, Gs^Fds
Gll, Gll, Ss^Qhu, Gll^Em, Gll^Em, Gll, Ss^Qhu, Ss^Qhu, Ww^Qhu, Ss^Qhu, Ds^Qhu, Ds^Qhu, Ds^Qhu, Ds^Qhu, Gg, Gg, Rd, Gs, Gs, Re^Edt, Re^Edt, Re, Gs, Gs^Edt, Gs, Gs, Gs, Gs, Hh, Gs^Fds, Gs^Fds, Gs^Fds, Hh, Hh, Gg, Gg, Gs^Vc, Rd, Gg, Gs^Fds, Gg, Gg
Ss^Qhu, Ss^Qhu, Ww^Qhu, Ww^Edt, Ss^Qhu, Gll, Gll, Ss^Qhu, Ww^Qhu, Ss^Qhu, Ww^Qhu, Ww^Qhu, Ww^Qhu, Ds^Qhu, Gg, Gg, Rd, Gs, Gs, Re^Edt, Gs, Re^Edt, Gg, Gs^Edt, Gs^Fds, Gs, Gs^Fds, Gs, Gs^Fds, Gs^Fds, Gg, Gg, Rb, Gg, Gg, Gg, Gg, Rd, Rd, Gg, Gg, Gg
Ss^Qhu, Ww^Qhu, Ww^Qhu, Ss^Qhu, Ss^Qhu, Gll, Gll^Vhs, Ss^Qhu, Ss^Qhu, Ww^Qhu, Ds^Qhu, Ds^Qhu, Ds^Qhu, Ww^Qhu, Ww^Qhu, Gg, Gg, Rd, Gs, Gs, Gd^Edt, Gs, Gg, Gg, Gs^Fds, Gs^Fds, Hh, Hh, Hh, Hh^Fds, Re, Re, Gd^Edt, Gd^Edt, Gs, Gs, Gg, Gg, Gg, Rd, Rd, Gg
Ss^Qhu, Ss^Qhu, Ss^Qhu, Ss^Qhu, Gll, Gll^Em, Gll^Emf, Gll^Em, Ss^Qhu, Ss^Qhu, Rd^Qhu, Ds^Qhu, Rd^Qhu, Ds^Qhu, Ww^Qhu, Gg, Gg, Rd, Gg, Gg, Gd^Edt, Re, Re^Edt, Gg, Gg, Gg, Gg, Gg, Gg, Gg, Re, Gd^Edt, Gs, Gd^Edt, Gs, Gs, Gs, Gs, Gg, Gg, Gg, Rd
Ss^Qhu, Ds, Ds, Ss^Qhu, Gll, Gll^Em, Gll, Gll, Ww^Edt, Ss^Qhu, Rd^Qhu, Rd^Qhu, Ss^Qhu, Ds^Qhu, Ww^Qhu, Gg, Rd, Rd, Gg, Gg, Gg, Gd^Vhr, Re, Gg^Edt, Gs, Gg, Gg, Gg, Gs, Gg, Gg, Gg, Gg, Gs, Gs, Gs, Gg, Gs, Gg, Gg, Gg, Gg
Ds, Ds, Ds, Ss^Qhu, Ds, Ss^Qhu, Ss^Qhu, Ss^Qhu, Ww^Edt, Gll, Gll, Ss^Qhu, Ss^Qhu, Ss^Qhu, Ds, Ww^Qhu, Ww^Qhu, Gg, Ww^Qhu, Gg, Gg, Gd^Edt, Gs, Gg, Gs, Gg, Gs, Gs^Edt, Gd^Edt, Gd^Edt, Gg, Gg, Gs, Gs, Gs, Gs, Gg, Gg, Gg, Gg, Ww^Qhu, Gg
Ds, Ds, Ds^_ml, Ds, Ds, Ss^Qhu, Ss^Qhu, Ww^Edt, Ww^Edt, Ss^Qhu, Gll, Gll, Gg, Gll, Rd, Ds, Gs^Fds, Ww^Qhu, Gg, Ww^Qhu, Ww^Qhu, Gg, Gg, Gs^Fms, Gs^Fms, Gs^Fds, Gs, Gd^Edt, Rb, Re, Gg, Gg, Gg, Gg, Gg, Gg, Ww^Qhu, Gg, Ww^Qhu, Ww^Qhu, Wo^Qhu, Ww^Qhu
Ds, Ds, Rd, Ds, Ds, Ss^Qhu, Ss^Qhu, Ww^Edt, Ss^Qhu, Ss^Qhu, Gg, Gg, Gg, Rd, Re^Edt, Gg, Gs^Fds, Gs^Fds, Gg, Ds, Ds, Ww^Qhu, Gs^Fds, Gs^Fds, Gs^Fds, Gs^Fds, Gs^Fds, Gg, Gg, Gs, Gg, Gg, Gg, Gg, Ww^Qhu, Ww^Qhu, Ww^Qhu, Ww^Qhu, Wo^Qhu, Wo^Qhu, Ww^Qhu, Ww^Qhu
Gs^Fds, Gs^Fds, Rd, Rd, Ds, Rd, Gll, Ss^Qhu, Gll, Gll, Gg, Gg, Rd, Rd^Edt, Gs^Vc, Gs^Fds, Gs^Fms, Gs^Fds, Gg, Gg, Ds, Ww^Qhu, Ww^Qhu, Ww^Qhu, Ww^Qhu, Ww^Qhu, Ww^Qhu, Ww^Qhu, Ww^Qhu, Gg, Ww^Qhu, Ww^Qhu, Ww^Qhu, Ww^Qhu, Ww^Qhu, Ww^Qhu, Ww^Qhu, Ww^Qhu, Gs^Fds, Gs^Fds, Gs^Fds, Gs^Fds
Gs^Fds, Gs^Fds, Gll, Gg, Gg, Rd, Gll, Gll, Gg, Gll, Gg, Rd, Gg, Re, Re, Gg, Gs^Fds, Gs^Fms, Gs^Fds, Gg, Gg, Ds, Gs^Fds, Gs^Fds, Gs^Fds, Gs^Fds, Gs^Fds, Gs^Fds, Ww^Qhu, Ww^Qhu, Ww^Qhu, Wo^Qhu, Wo^Qhu, Wo^Qhu, Gg, Gg, Gg, Gg, Gg^Vc, Gs^Fds, Gs^Fds, Gs^Fds
Gs^Fds, Gg, Gg, Re^Vc, Re, Gg, Gg, Gg, Gg, Gg, Rd, Rd, Gg^Edt, Gg, Gg, Gs^Fds, Gs^Fds, Gs^Fms, Gg^Efm, Gg^Efm, Gs^Fds, Gs^Fms, Gs^Fds, Gs^Fds, Gs^Fds, Gs^Fds, Gg, Ds, Ww^Qhu, Ww^Qhu, Wo^Qhu, Wo^Qhu, Ds, Gg, Gs^Fds, Gg, Gs^Fds, Gg, Re, Gs^Fds, Re, Gg
Gs^Fds, Gs^Fds, Gs^Fds, Re, Gg, Gg, Gg, Gg, Rd, Rd, Gg, Gg, Gg, Gg, Gg, Gg, Gg, Gg, Gg^Efm, Gg, Gs^Fds, Gs^Fms, Gs^Fms, Gs^Fms, Gs^Fds, Gs^Fds, Ds, Ds, Ww^Qhu, Ww^Qhu, Wo^Qhu, Ds, Gs^Fds, Gg, Gs^Fds, Gs^Fds, Gs^Fds, Gg, Gg, Re, Gg, Re
Gs^Fds, Gs^Fds, Gg, Gg, Gg, Gg, 1 Gg, Gg, Rd, Gg, Gg, Gg, Gg, Gg, Gg, Gg^Efm, Gg, Gg, Gg, Gg, Gg, Gs^Fds, Gg, Gs^Fds, Gg, Gg, Ds, Ds, Ww^Qhu, Ww^Qhu, Ds, Ds, Gs^Fds, Gs^Fds, Gs^Fds, Gs^Fds, Gs^Fds, Gs^Fds, Gg, Gg, Gg, Gg
Gs^Fds, Gg, Gg, Gg, Gg, Gg, Gg, Rd, Gg, 2 Gg, Gg, Gg, Gg, Gg, Gs^Fds, Gg, Gs^Fms, Gs^Fds, Gg, Gg^Efm, Gg, Gg, Ds, Gg, Ds, Ds, Ww^Qhu, Ww^Qhu, Wo^Qhu, Ww^Qhu, Ds, Gs^Fds, Gs^Fds, Gs^Fds, Gs^Fds, Gs^Fds, Gs^Fds, Gg, Gs^Fds, Gs^Fds, Gs^Fds, Gg
Gg, Gg, Gg, Gg, Gg, Gg, Gg, Rd, Gg, Gg, Gg, Gg, Gg, Gs^Fms, Gs^Fds, Gs^Fds, Gs^Fds, Gs^Fds, Gg, Gg, Gg, Gg, Ds, Ds, Ww^Qhu, Ww^Qhu, Ww^Qhu, Wo^Qhu, Ds, Ds, Gs^Fds, Gs^Fds, Gs^Fds, Gs^Fds, Gs^Fds, Gs^Fds, Rb^Gvs, Gs^Fds, Gg, Gs^Fds, Gg, Gs^Fds
