Gs, Gg, Gg, Gg, Gg, Gg, Gg, Gg, Gg, Gs, Gs, Gs
Gg, Gs, Gg, Gg, Gg, Gg, Gg, Gg, Gs, Gs^Edt, Gs^Edt, Gs
Gg, Gg, Gg, Gg, Chr, Chr, Chr, Gg, Re, Gs^Edt, Gs^Edt, Gs
Gg, Gg, Gg, Gg, Chr, Khr, Chr, Re, Re, Rb^Vhr, Gs^Edt, Gs^Edt
Gg, Gg, Gg, Re, Re, Chr, Khr, Chr, Gg, Re, Gs, Gg
Gg, Rb, Re, Re, Re, Chr, Chr, Chr, Gg, Gg, Gg, Gg
Gg, Gg, Re, Gg, Gg, Gg^_ml, Gg, Gg, Gg, Gg, Gg, Gg
Gg, Gg, Re, Gg, Gg, Gg, Gg, Gg, Gg, Gg, Gs, Gs^Fds
Re, Re, Gg, Gg, Gg, Gg, Gg, Gg, Gg, Gs^Fds, Gs^Fds, Gs
