Gll^Fdf, Gll^Fdf, Gll^Fdf, Gll^Fdf, Gd, Gd, Ds, Ww, Ww, Ds, Ds, Gd, Gd, Gd, Gll, Gll, Gll, Gll, Gll, Gd, Gd, Gd, Gd, Gs^Fdf, Gs^Fdf, Gs^Fdf, Gs^Fdf, Gs^Fdf, Gs^Fdf, Gs^Fdf, Gs^Fdf, Gs^Fdf, Gs^Fdf, Gs^Fdf, Ww, Ww, Hhd^Qhhf, Gg^Qhhf, Gs^Fdf, Gg, Gs^Fdf, Gg, Gs^Fdf, Gg, Gs^Fdf, Gll^Fmf, Gll^Fmf, Gs^Fdf, Gs^Fdf, Gs^Fdf, Gs^Fdf, Gs^Fdf, Gs^Fdf, Gs^Fdf, Gs^Fdf, Gs^Fdf, Gll^Fmf, Gs^Fdf, Gs^Fdf, Gs^Fdf, Gs^Fdf, Gs^Fdf, Gs^Fdf, Gs^Fdf, Gs^Fdf, Gs^Fdf, Gs^Fdf, Gs^Fdf
Gll^Fdf, Gll^Fdf, Gll^Fdf, Gll^Fdf, Gd, Gd, Rd, Ds, Ww, Ww, Ds, Gd, Gd, Gd, Gs^Fdf, Gll, Gs^Fdf, Gd, Gs^Fdf, Gd, Gs^Fdf, Gs^Fdf, Gs^Fdf, Gs^Fdf, Gd, Gs^Fdf, Hhd^Fdf, Hhd^Fdf, Hhd^Fdf, Hhd^Fdf, Hhd^Fdf, Gs^Fdf, Gs^Fdf, Gs^Fdf, Ww, Hhd^Qhhf, Hhd^Qhh, Hhd^Fdf, Hhd, Gs^Fdf, Hhd, Gs^Fdf, Gs^Fdf, Gs^Fdf, Gll^Fmf, Gll^Fmf, Gll^Fmf, Gll^Fmf, Gs^Fdf, Gs^Fmf, Gs^Fdf, Gs^Fdf, Gs^Fdf, Gs^Fdf, Gll^Fmf, Gll^Fmf, Gll^Fmf, Gll^Fmf, Gs^Fdf, Gs^Fdf, Gs^Fdf, Gs^Fdf, Gs^Fdf, Gs^Fdf, Gs^Fdf, Gs^Fdf, Gs^Fdf, Gs^Fdf
Gll, Gll, Gll^Em, Gll, Gll, Gll, Rd, Rd, Ds, Ww, Ww, Ds, Gs^Fdf, Gs^Fdf, Gs^Fdf, Gll, Gll, Gd^Vc, Gd, Gd, Gs^Fdf, Gs^Fdf, Gll^Fmf, Gd, Hhd^Fdf, Hhd^Fdf, Hhd^Fdf, Hhd^Fdf, Hhd, Hhd, Hhd^Fdf, Hhd^Fdf, Hhd^Fdf, Gs^Fdf, Hhd^Fdf, Ww, Hhd^Qhh, Hhd, Gs^Fdf, Hhd, Gs^Vc, Gs^Fdf, Gs^Fdf, Gs^Fdf, Gll^Fmf, Gll^Fmf, Gll, Gll^Fmf, Gs^Fdf, Ss^Qhu, Ss^Qhu, Ss^Qhu, Ss^Qhu, Gll^Fmf, Ss^Qhu, Gll^Fmf, Gll^Fmf, Gll^Fmf, Gs^Fdf, Gll^Fmf, Gll^Fmf, Gll^Fmf, Gs^Fdf, Gs^Fdf, Gs^Fdf, Gs^Fdf, Gd, Gs^Fdf
Gll^Em, Gll^Em, Gll^Fdf, Gll, Gll, Gd, Gd, Gd, Ds, Ww, Ww, Gll^Fdf, Gd, Gs^Fdf, Gd, Gs^Fdf, Gll, Gll, Gd, Gd, Gd, Gd, Rd, Gd, Rd, Hhd^Fdf, Rd, Gll^Fmf, Hhd, Hhd^Fdf, Hhd^Fdf, Hhd^Fdf, Ww, Hhd^Fdf, Ww^Es, Ww^Es, Gs^Qhh, Gs^Fdf, Gs^Fdf, Gd, Gd, Gd, Gd, Gd, Gll, Gll, Ss, Gs^Fdf, Gll, Ss^Qhu, Gll, Ss^Qhu, Ss^Qhu, Ss^Qhu, Gll^Fmf, Gll^Fmf, Gs^Fdf, Gs^Fdf, Gll^Fmf, Gll^Fmf, Gs^Fdf, Gll^Fmf, Gd, Gd, Gd, Gd, Gd, Gd
Gll^Fdf, Gll^Fdf, Gll^Fdf, Gll^Em, Gll^Fdf, Gd, Gd, Ds, Rd, Ds, Ww, Gll^Fdf, Ds, Gd, Gd, Gll, Gll, Gll, Gll, Gs^Fdf, Rd, Rd, Hhd^Fdf, Rd, Gd, Rd, Gd, Rd, Rd, Gd, Gd, Hhd^Fdf, Ww^Es, Ww^Es, Hhd^Qhh, Hhd^Qhh, Hhd, Gs^Fdf, Gd, Gs^Fdf, Gd, Gd, Ss^Qhu, Gll, Ss, Ss, Re, Ss^Qhu, Ss^Qhu, Gll, Gll^Em, Gll, Ss^Qhu, Ss^Qhu, Gll^Fmf, Gs^Fdf, Gs^Fdf, Gs^Fdf, Gd, Gs^Fdf, Gd^Vc, Gs^Fdf, Gd, Gd, Ce, Ce, Gd, Gd
Gll^Fdf, Gll^Fdf, Gll^Fdf, Gll^Fdf, Gll^Fdf, Gd^Vhr, Gd, Gd, Rd, Ds, Ds, Ww, Wo, Ds, Ds, Gd, Gd, Gd, Gd, Rd, Gs^Fdf, Gs^Fdf, Hhd^Fdf, Gd, Hhd, Hhd, Hhd, Hhd^Fdf, Rd, Rd, Gd^Vh, Gd, Ww, Hhd^Qhh, Hhd^Qhh, Gs^Fdf, Hhd, Gs^Fdf, Gd, Gd, Ss^Qhu, Gll, Gll, Gll, Re, Re, Ss^Qhu, Rb, Rb, Re^Feth, Ss^Qhu, Gll, Re, Ss^Qhu, Gll, Gs^Fdf, Gd, Gd, Gd, Gd, Gd, Gd, Gd, Gd, Ce, 1 Ke, Gd, Gd
Gll^Fdf, Gll^Fdf, Gll^Fdf, Gll^Fdf, Gll^Fdf, Gll^Fdf, Gd, Rd, Gd, Rd, Ds, Ww, Wo, Ww, Ds, Gd, Gd, Gd, Rd, Rd, Gs^Fdf, Gll^Fmf, Hhd^Fdf, Hhd^Fdf, Hhd^Fdf, Hhd^Fdf, Hhd^Fdf, Hhd, Hhd, Rd, Rd, Ww, Gd^Qhh, Gd^Qhh, Gd, Gd, Gd, Gd, Gd, Gll, Re, Ss^Qhu, Re, Re, Ss^Qhu, Ss^Qhu, Ss^Qhu, Ss^Qhu, Ss^Qhu, Rb, Ss^Qhu, Rb, Rb, Gll, Gll, Gll, Gd, Gd, Gd, Gd, Rd, Rd, Rd, Rd, Rd, Re, Gd, Gd
Rd, Gll^Fdf, Gd, Gll^Fdf, Gll^Fdf, Gd, Gd, Gd, Rd, Rd, Rd, Ds, Gd, Wo, Ww, Gd, Gd, Rd, Gd^Vc, Gll, Gll, Gll^Fmf, Gll^Fmf, Gll^Fmf, Gll^Fmf, Hhd^Fdf, Hhd^Fdf, Hhd, Hhd, Rd, Hhd, Wwf^Es, Ww, Rd, Rd, Rd, Rd, Rd, Rd, Re, Gll^Fp, Re, Ss^Qhu, Gll, Gll, Ss^Qhu, Sm^Tf, Ss^Qhu, Ss^Qhu, Rb, Ss^Qhu, Ss^Qhu, Ss^Qhu, Ss^Qhu, Ss^Qhu, Gll, Rd, Gd, Rd, 3 Rd, Gd, Gd, Gd, Gd, Ce, Rd, Rd, Rd
Dd, Rd, Rd, Gd, Gd, Gd, Gd, Gd, Gd, Rd, Gd, Gd, Gd, Ww, Ww, Ww, Rd, Rd, Gd, Gll, Gd, Gll^Fmf, Ww, Ww, Ww, Hhd, Ww, Hhd, Wwr, Hhd, Ww^Es, Hhd, Wwr, Gd, Gd, Gd, Hhd, Gll^Fp, Gll^Fp, Gll^Fp, Gll^Fp, Gll^Fp, Ss^Qhu, Gll, Gll^Em, Ss^Qhu, Sm^Tf, Sm^Tf, Rb^Emf, Re, Re, Ss^Qhu, Re, Re, Re, Re, Gd, Rd, Gd, Gd, Gd, Gd, Gd, Gd, Ce, 2 Ke, Re, Gd
Dd, Dd, Rd, Gd, Gd, Hhd, Cd^Vda, Hhd, Gd, Rd, Gd, Gd, Rd, Gd, Ww^Bw/r, Ww^Bw/, Ds, Gd, Ds, Gd, Ds, Ww, Wo, Wo, Wo, Ww, Wo, Ww, Ww, Ww^Es, Hhd^Qhh, Ww^Es, Hhd^Qhh, Hhd^Qhh, Hhd, Hhd, Hhd^Fp, Hhd^Fp, Hhd^Fp, Hhd^Fp, Hhd^Fp, Gd, Gd, Gll^Em, Ss^Qhu, Ss^Qhu, Ss^Qhu, Rb^Vhs, Rb^Em, Rb^Edt, Re^Edt, Re, Gll, Gll, Ss, Gll, Gll^Fmf, Gd, Gd, Gd, Gd, Gd, Gd, Gd, Gd, Ce, Gd, Gd
Gd, Gd, Gd, Rd, Rd, Rd, Rd, Hhd, Rd, Rd, Rd, Rd, Gd, Rd, Gd, Ww, Ww, Ds, Ww, Ds, Ww, Ww, Ww, Wo, Ww, Wo, Ww, Wo, Ww, Ww^Es, Ww, Hhd^Qhh, Hhd^Qhh, Hhd^Qhh, Gd, Hhd, Gs^Vc, Hhd^Fp, Hhd, Hhd, Gd, Gd, Gll, Gll, Ss^Qhu, Ss^Qhu, Ss^Qhu, Ss^Qhu, Ss^Qhu, Ss^Qhu, Sm^Tf, Gll, Ss^Qhu, Gll, Gll^Em, Gll, Gll^Fp, Gll^Fmf, Gll^Fmf, Gll^Fmf, Gll^Fp, Gd, Gd^Vhs, Gd, Gd, Gd, Gd, Gd
Hhd, Hhd, Hhd, Gd, Gd, Gd, Gd, Rd, Gd, Gd, Gd, Gd, Hhd, Gd^Vhr, Hhd, Ww, Ww, Ww, Ww, Ww, Ww, Ww, Gll^Fdf, Ww, Gll^Fdf, Ww, Hhd, Ww, Hhd, Hhd, Ww^Es, Hhd^Qhh, Hhd^Qhh, Hhd^Qhh, Hhd^Qhh, Gd, Gd, Hhd, Gd, Hhd, Hhd, Gd, Ss^Qhu, Gll, Gll, Gll, Gll^_mh, Gll, Gll, Ss^Qhu, Ss^Qhu, Ss^Qhu, Gll^Vhs, Gll^Em, Gll^Em, Ss^Qhu, Ss^Qhu, Gll^Fmf, Gll^Fmf, Gll^Fmf, Ss^Qhu, Ss^Qhu, Ss^Qhu, Ss^Qhu, Gd, Gd, Gd, Gd
Hhd, Hhd, Hhd, Gd^Vhr, Hhd, Gd, Gd, Gd, Gd, Gd, Gd, Gd, Hhd, Hhd, Hhd, Hhd, Gd, Gll^Fmf, Gll^Fmf, Gll^Fmf, Gll^Fmf, Gll^Fmf, Gll^Fmf, Gll^Fdf, Ww, Ww, Hhd, Hhd, Hhd, Ww^Es, Hhd^Qhh, Hhd^Qhh, Hhd^Qhh, Hhd^Qhh, Hhd^Qhh, Gd, Hhd^Qhh, Gd, Gd, Gd, Gd, Gd, Ss^Qhu, Ss^Qhu, Gll, Gll, Ss^Qhu, Gll^Em, Gll, Gll, Gll, Gll^Em, Gll, Ss^Qhu, Ss^Qhu, Ss^Qhu, Ss^Qhu, Gll^Fp, Gll^Fp, Gll^Fp, Gll^Fp, Ss^Qhu, Ss^Qhu, Ss^Qhu, Ss^Qhu, Gd, Gd, Gd
Hhd, Hhd, Hhd, Hhd, Hhd, Gd, Gd, Gd, Gd, Gd, Gd, Gd, Gd, Gd, Gd, Gd, Gs^Fdf, Gll^Fmf, Gs^Fdf, Gs^Fdf, Gll^Fmf, Gll^Fdf, Hhd^Fdf, Gll^Fdf, Hhd^Fdf, Hhd^Fdf, Hhd^Fdf, Hhd^Fdf, Hhd^Fdf, Ww, Ww, Hhd^Qhh, Hhd^Qhh, Hhd^Qhh, Hhd^Qhh, Hhd^Qhh, Hhd^Qhh, Gd, Gd, Gd, Gd, Gd, Gll, Gll, Gll, Ss^Qhu, Ss^Qhu, Ss^Qhu, Ss^Qhu, Gll, Ss^Qhu, Gll, Ss^Qhu, Ss^Qhu, Ss^Qhu, Ss^Qhu, Ss^Qhu, Ss^Qhu, Gll^Fp, Gll^Fp, Gll^Fp, Gll^Fp, Gll^Fp, Ss^Qhu, Ss^Qhu, Gd, Gd, Gd
Hhd, Hhd, Hhd, Hhd, Hhd, Hhd, Hhd, Gd, Gd, Gd, Gd, Gd, Gd, Gd, Gd, Gd, Gd, Gd, Gd, Gs^Fdf, Gg, Gg, Gg, Hhd^Fdf, Gg, Hhd, Gg, Hhd, Gg, Hhd, Ww, Ww, Gg, Hhd, Gg, Hhd^Qhh, Gd, Gd, Gd, Gd, Gd, Gd, Gd, Ss^Qhu, Ss^Qhu, Ss^Qhu, Ss^Qhu, Ss^Qhu, Ss^Qhu, Ss^Qhu, Ss^Qhu, Ss^Qhu, Gg, Ss^Qhu, Gg, Ss^Qhu, Gg, Ss^Qhu, Gll^Fp, Gll^Fp, Gll^Fp, Gll^Fp, Gll^Fp, Ss^Qhu, Ss^Qhu, Ss^Qhu, Gd, Gd
