Gg, Gg, Gg, Gg, Gg, Gg, Gg, Gg, Gg, Gg, Gg, Gg, Gg, Ds, Ww, Ww, Gs, Gs, Gs, Gs, Gs, Gs, Gs, Gs, Gg, Gs, Gs^Fms, Gs^Fms, Gs^Fms, Gs^Fms, Gs^Fms, Gg, Gs^Fds, Gs^Fds, Gs^Fds, Gs^Fds, Gs^Fds, Gs^Fds, Gs^Fds, Gs^Fds, Gs^Fds, Gs^Fds, Gs^Fds, Gs^Fds, Gs^Fds, Gs^Fds, Gs^Fds, Gs, Gs, Gs, Gs, Gg, Gg, Gg, Gg, Gg, Gg
Gg, Gg, Gg, Gg, Gg, Gg, Gg, Gg, Gg, Gg, Gg, Gg, Gg, Ds, Ww, Ww, Ww, Gs, Gs, Gs, Gs^Efm, Gg^Efm, Gg^Efm, Gg, Gg, Gs^Fms, Gs^Fds, Gs^Fds, Gs^Fms, Gs^Fds, Gs^Fds, Gs^Fds, Gs^Fms, Gs^Fds, Gs^Fds, Gs^Fds, Gs^Fds, Gs^Fds, Gs^Fds, Gs^Fds, Gs^Fds, Gs^Fds, Gs^Fds, Gs^Fds, Gs^Fds, Gs^Fds, Gs^Fds, Gs, Gg, Gg, Gg^Efm, Gg, Gg, Gg, Gg, Gg, Gg
Gg, Gg, Gg, Gg, Gg, Gg, Gg, Gs^Fds, Gg, Gg, Gg, Gg, Gs^Fds, Ds, Ds, Ww, Ww, Gs, Gs, Gs, Gs, Gs, Gs, Gs, Hh, Gs^Fds, Hh^Fds, Gs^Fds, Gs^Fds, Gs^Fds, Gs^Fds, Gs^Fds, Gs^Fms, Gs^Fds, Gs^Fms, Gs^Fds, Gs^Fms, Gs^Fms, Gs^Fms, Gs^Fds, Gs^Fds, Gs^Fds, Hh^Fds, Hh, Hh, Gs^Fds, Gs, Gg, Gs, Gg^Efm, Gs, Gs^Efm, Gg, Gg, Gs^Fds, Gg, Gs^Fds
Gg, Gg, Gg, Gg, Gg, Gg, Gs^Fds, Gs^Fds, Gs^Fds, Gg, Gg, Gg, Gs^Fds, Gg, Ww, Ww, Ww, Ww, Ds, Ds, Hh, Hh, Hh, Gs, Hh, Hh, Hh, Gs^Fds, Gs^Fds, Gs^Fds, Gs^Fds, Gs^Fms, Gs^Fms, Gs^Fms, Gs^Fms, Gs^Fms, Gll^Fp, Gll^Fp, Gll^Fp, Gs^Fms, Hh^Fds, Hh, Hh, Hh, Gs^Fds, Gs^Fds, Gs, Gs, Gs^Fds, Gg, Re, Gs, Gs, Gg, Gs^Fds, Gs^Fds, Gs^Fds
Gg, Gg, Gg, Gg, Gg, Gs^Fds, Gs^Fds, Gs^Fds, Gg, Gg, Gs^Fds, Gll^Fp, Gs^Fds, Wwr, Gs^Fds, Gs^Fds, Gs^Fds, Ww, Ww, Ds, Ds, Hh, Hh, Hh^Fds, Hh^Fds, Hh, Gs^Fds, Gs^Fds, Gs^Fds, Gs, Gs, Gs^Fds, Gs^Fms, Gs^Fms, Gs^Fms, Gs^Fds, Gll, Ss, Gll^Fp, Gll^Fp, Gs^Fds, Hh^Fds, Hh, Hh^Fds, Hh, Gs, Hh, Gs^Fds, Gs^Fds, Gg, Re, Gs^Vc, Gg, Gs^Fds, Gg, Gs^Fds, Gs^Fds
Gg, Gg, Gg, Gg, Gg, Gg, Gg, Gs^Fds, Gg, Gg, Gs^Vl, Gll^Fp, Gs^Fms, Gs^Fds, Gs^Fms, Gs^Fds, Gs^Fds, Wo, Wo, Ww, Ds, Hh, Hh, Hh^Fds, Hh, Hh, Gs^Fds, Gs^Fds, Gs^Fds, Gs^Fds, Gs, Gs, Gs, Gs, Ss, Ss, Gll, Gll^Fp, Gs^Fms, Gs^Fds, Hh^Fds, Hh, Hh, Hh, Hh, Hh, Hh^Fds, Gs^Fds, Gs^Fds, Gs^Fds, Gg, Re, Gg, Gg, Ce, Gg, Gg
Gg, Gg, Gg, Gg, Gs, Gg, Gg, Gg, Gg, Gg, Gs^Fds, Gs^Fms, Gs^Fms, Gs^Fms, Gs^Fds, Gs^Fds, Ww, Gs^Fds, Ww, Ww, Ds, Ds, Hh, Hh^Fds, Hh, Gg, Gg, Gs^Fds, Gs, Gs, Rb, Gs, Rb, Rb, Rb, Ss, Rb^Vhs, Gll, Gll, Hh, Hh, Hh, Hh, Hh^Fds, Hh, Hh^Fds, Hh^Fds, Hh^Fds, Gg, Gg, Gg, Gg, Gg, Ce, 1 Ke, Gg, Gg
Re, Gg, Gg, Gg, Gs, Gs, Gs, Gs, Gs, Gs^Fds, Gs^Fms, Gs^Fms, Gll^Fp, Gs^Fms, Gs^Fms, Wwr, Gs^Fds, Ww, Gg, Ww, Ww, Ds, Ds, Gg, Gg, Gg, Re, Gs^Vc, Re, Rb, Ss, Rb, Ss, Ss, Ss, Rb, Rb, Ss, Hh, Hh^Fds, Hh^Fds, Hh, Hh^Fds, Hh, Hh, Hh, Gg^Fds, Gs, Gg, Gg, Gg, Gg, Re, Ce, Re, Gg, Gg
Gg, Re, Re, Gg, Gg, Gs, Gs, Gs, Gs, Gs, Hh, Gll^Fp, Gll^Fp, Gll^Fp, Gs^Fms, Gs^Fds, Gg, Gg, Gg, Ww, Ww, Ww, Gg, Gg, Re, Re, Gs^Fds, Re, Gll^Fp, Gll^Fp, Ss, Ss, Ss, Ss, Ww^Ewf, Ss, Rb, Ss, Hh, Hh, Hh, Hh, Hh, Hh^Fds, Gs, Hh, Gs, Gs, Re, Gg, Re, Re, Gg, Re, Gg, Re, Gg
Gg, Gg, Re, Gg, Gg, Gs, Gs, Hh, Hh, Hh, Hh, Gll^Fp, Gs^Fds, Gs^Fms, Gg, Gg, Gs^Vc, Gs^Fms, Gs^Fds, Gs, Gs, Ww, Wwf, Re, Gs^Fds, Gs^Fds, Gs^Fms, Gs^Fms, Gll^Fp, Ss, Ss, Gll^Em, Gll^Em, Gll^Em, Ss, Rb, Rb, Ss, Gs^Fds, Gs^Fds, Hh, Hh^Fds, Gs^Fds, Hh^Fds, Gs^Fds, Gs, Re, 3 Re, Gs, Re, Gg, Gg, Gg, Ce, 2 Ke, Gg, Gg
Gg, Gg, Gg, Re, Re, Re, Re, Gs, Gs^Vc, Hh, Hh, Hh, Hh, Gg, Gs, Gs, Gs, Gs^Fds, Gs, Gs, Re, Re, Ww, Gg, Gs^Fds, Gs^Fds, Ss, Gll^Fp, Ss, Ss, Gll^Em, Ss, Ww^Ewl, Ww^Ewl, Ww^Edt, Ss, Rb, Ss, Ss, Ss, Ss, Gs^Fds, Gs^Fms, Gs^Fds, Rb, Rb, Gs, Gs, Gs, Gg, Gg, Gg, Gg, Ce, Ce, Gs, Gs
Gg, Gg, Gg, Gg, Gg, Gg, Gg, Re, Re, Hh, Re, Hh, Hh, Hh, Gs, Gs, Re, Re, Re, Re, Gg, Gg, Ww, Ww, Ww, Ww, Ss, Ww, Ss, Ss^Vhs, Gll^Edt, Ss, Ss, Ss, Gll^Em, Gll^Edt, Ss, Rb, Rb, Ss, Rb, Rb, Rb, Rb, Gs, Gs, Gs, Gs, Gs^Fds, Gs, Gg, Gg, Re, Gg, Gs, Gs, Gg
Gg, Gg, Gg, Gg, Gg, Gg, Gg, Gg, Hh, Re, Hh, Re, Re, Gs, Re, Re, Gg, Gg, Gg, Gg, Ds, Ds, Hh, Hh, Ss, Ss, Ss, Gs^Fds, Ss, Ss, Ss, Gll^Edt, Ss, Gll^Em, Ss, Gll^Edt, Gll^Em, Ss, Rb^Vhs, Rb, Ss, Gll, Ss, Gs^Fds, Gs^Fds, Gs^Fds, Gs, Gs^Fds, Gs^Fds, Gs^Fds, Gg, Gg, Re, Gs, Gs, Gs, Gg
Gg, Gg, Gg, Gg, Gg, Gg, Gg, Gg, Hh, Hh, Hh, Hh, Hh, Re, Hh, Gg, Rd, Rd, Rd, Rd, Ds, Ds, Hh, Hh, Hh, Hh, Hh^Fds, Gs^Fds, Gs^Fds, Gs^Fds, Ss, Ss, Ss, Ss, Gll^Em, Ss, Ww^Ewl, Ww^Ewl, Gll^Edt, Ss, Gll, Gll, Ss, Ss, Gs^Fms, Gs^Fds, Gs^Fds, Gs, Gg, Gg, Gg, Gs^Vc, Gs, Gs, Gs^Efm, Gs, Gg
Gg, Gg, Gg, Gg, Hh, Gg, Gg, Hh, Hh, Hh, Hh, Hh, Hh, Hh, Ds, Ds, Ds, Ds, Ds, Ds, Ds, Hh, Hh, Hh, Hh, Hh^Fds, Hh^Fds, Gs^Fds, Ss, Ss, Ss, Ww^Ewl, Ww^Ewf, Ss, Gll^Em, Gll^Em, Gll^Em, Ss, Ss, Ss, Ss, Ss, Ss, Gs^Fds, Gs^Fms, Gs^Fms, Gg, Gg, Gs^Fds, Gg, Gg, Gg, Gg, Gg, Gs^Efm, Gs, Gg
Hh, Hh, Hh, Gg, Hh, Gg, Hh, Hh, Hh, Hh, Hh, Hh, Hh, Hh, Hh, Ds, Hh, Ds, Hh, Hh, Hh, Ds, Hh, Hh, Hh, Hh, Hh^Fds, Hh^Fds, Hh^Fds, Ss, Ss, Ss, Ww^Ewl, Gll^Em, Ss, Gll^Em, Ss, Gll, Gll, Hh, Hh, Hh, Ss, Gs^Fds, Gs^Fms, Gs^Fms, Gs^Fms, Gs^Fds, Gs^Fds, Gs^Fds, Gs^Fds, Gs^Fds, Gg, Gg, Gg, Gg, Gg
Hh, Hh, Hh, Hh, Dd, Hh, Gg, Hh, Hh, Hh, Gg, Hh, Gg, Hh, Gg, Hh, Hh, Hh, Hh, Hh, Hh, Hh, Hh, Hh, Hh, Hh, Hh, Hh^Fds, Hh^Fds, Hh^Fds, Gg, Ss, Ss, Ss, Ss, Ss, Ss, Hh, Hh, Hh, Hh, Hh, Gs^Fds, Gs^Fds, Gs^Fds, Gs^Fms, Gs^Fds, Gs^Fms, Gs^Fds, Gs^Fds, Gg, Gg, Gg, Gg, Gg, Gg, Gg
