Dd, Dd, Dd, Gg, Gs, Gs, Ds, Ww, Ww, Ds, Ds, Gg, Gg, Gg, Gs, Gs, Gs, Gg, Gg, Gg, Gg, Gg, Gg, Gs^Fds, Gs^Fds, Gs^Fds, Gs^Fds, Gs^Fds, Gs^Fds, Gs^Fds, Gs^Fds, Gs^Fds, Gs^Fds, Gs^Fds, Ww, Ww, Gs^Fds, Gg, Gs^Fds, Gg, Gs^Fds, Gg, Gs^Fds, Gg, Gs^Fds, Gs^Fms, Gs^Fms, Gs^Fds, Gs^Fds, Gs^Fds, Gs^Fds, Gs^Fds, Gs^Fds, Gs^Fds, Gs^Fds, Gs^Fds, Gs^Fms, Gs^Fds, Gs^Fds, Gs^Fds, Gs^Fds, Gs^Fds, Gs^Fds, Gs^Fds, Gs^Fds, Gs^Fds, Gs^Fds, Gs^Fds
Dd, Dd, Dd, Dd, Gs, Gs, Rd, Ds, Ww, Ww, Ds, Gg, Gg, Gs, Gs^Fds, Gs, Gs^Fds, Gs, Gs^Fds, Gg, Gs^Fds, Gs^Fds, Gs^Fds, Gs^Fds, Gs, Gs^Fds, Hh^Fds, Hh^Fds, Hh^Fds, Hh^Fds, Hh^Fds, Gs^Fds, Gs^Fds, Gs^Fds, Ww, Gs^Fds, Hh, Gs^Fds, Hh, Gs^Fds, Hh, Gs^Fds, Gs^Fds, Gs^Fds, Gs^Fms, Gs^Fms, Gs^Fms, Gs^Fms, Gs^Fds, Gs^Fms, Gs^Fds, Gs^Fds, Gs^Fds, Gs^Fds, Gs^Fms, Gs^Fms, Gs^Fms, Gs^Fms, Gs^Fds, Gs^Fds, Gs^Fds, Gs^Fds, Gs^Fds, Gs^Fds, Gs^Fds, Gs^Fds, Gs^Fds, Gs^Fds
Gd, Gd, Gd, Gs, Gs, Gs, Rd, Rd, Ds, Ww, Ww, Ds, Gs^Fds, Gs^Fds, Gs^Fds, Gs, Gg, Gs^Vc, Gg, Gg, Gs^Fds, Gs^Fds, Gs^Fms, Gs, Hh^Fds, Hh^Fds, Hh^Fds, Hh^Fds, Hh, Hh, Hh^Fds, Hh^Fds, Hh^Fds, Gs^Fds, Hh^Fds, Ww, Hh, Hh, Gs^Fds, Hh, Gs^Vc, Gs^Fds, Gs^Fds, Gs^Fds, Gs^Fms, Gs^Fms, Gll, Gs^Fms, Gs^Fds, Ss, Ss, Ss, Ss, Gs^Fms, Ss, Gs^Fms, Gs^Fms, Gs^Fms, Gs^Fds, Gs^Fms, Gs^Fms, Gs^Fms, Gs^Fds, Gs^Fds, Gs^Fds, Gs^Fds, Gg, Gs^Fds
Gd, Gd, Dd, Gs, Gs, Gs, Gs, Gs, Ds, Ww, Ww, Gs^Fds, Gg, Gs^Fds, Gg, Gs^Fds, Gg, Gg, Gg, Gg, Gs, Gs, Rd, Gs, Rd, Hh^Fds, Rd, Gs^Fds, Hh, Hh^Fds, Hh^Fds, Hh^Fds, Ww, Hh^Fds, Ww, Ww, Gs^Fds, Gs^Fds, Gs^Fds, Gg, Gg, Gg, Gg, Gg, Gll, Gll, Ss, Gs^Fds, Gll, Ss, Gll, Ss, Ss, Ss, Gs^Fms, Gs^Fms, Gs^Fds, Gs^Fds, Gs^Fms, Gs^Fms, Gs^Fds, Gs^Fms, Gg, Gg, Gg, Gg, Gg, Gg
Dd, Dd, Dd, Gd, Dd, Gs, Gs, Ds, Rd, Ds, Ww, Gs^Fds, Ds, Gg, Gg, Gg, Gg, Gg, Gs, Gs^Fds, Rd, Rd, Hh^Fds, Rd, Gs, Rd, Gs, Rd, Rd, Gs, Gs, Hh^Fds, Ww, Ww, Hh, Hh, Hh, Gs^Fds, Gs, Gs^Fds, Gg, Gg, Ss, Gll, Ss, Ss, Re, Ss^Ewl, Ss^Ewl, Gll, Gll^Em, Gll, Ss, Ss, Gs^Fms, Gs^Fds, Gs^Fds, Gs^Fds, Gs^Vc, Gs^Fds, Gg, Gs^Fds, Gg, Gg, Ce, Ce, Gg, Gg
Hd, Hd, Dd, Dd, Dd, Gs, Gs, Gs, Rd, Ds, Ds, Ww, Wo, Ds, Ds, Gg, Gs, Gs, Gs, Rd, Gs^Fds, Gs^Fds, Hh^Fds, Gs, Hh, Hh, Hh, Hh^Fds, Rd, Rd, Gs^Vh, Gs, Ww, Hh, Hh, Gs^Fds, Hh, Gs^Fds, Gs, Gg, Ss, Gll, Gll, Gll, Re, Re, Ss, Rb, Rb, Re^Feth, Ss, Gll, Re, Ss, Gll, Gs^Fds, Gg, Gg, Gg, Gg, Gg, Gg, Gg, Gg, Ce, 1 Ke, Gg, Gg
Dd, Hd, Dd, Dd^Edpp, Dd, Dd, Gs, Rd, Gs, Rd, Ds, Ww, Wo, Ww, Ds, Gg, Gs, Gs, Rd, Rd, Gs^Fds, Gs^Fms, Hh^Fds, Hh^Fds, Hh^Fds, Hh^Fds, Hh^Fds, Hh, Hh, Rd, Rd, Ww, Gs, Gs, Gs, Gs, Gs, Gs, Gs, Gll, Re, Ss, Re, Re, Ss, Ss, Ss, Ss, Ss, Rb, Ss, Rb, Rb, Gll, Gll, Gll, Gg, Gg, Gg, Gg, Rd, Rd, Rd, Rd, Rd, Re, Gg, Gg
Rd, Dd, Gd, Dd, Dd, Gd, Gs, Gg, Gg, Gg, Rd, Ds, Gg, Wo, Ww, Gg, Gg, Rd, Gs^Vc, Gs, Gs, Gs^Fms, Gs^Fms, Gs^Fms, Gs^Fms, Hh^Fds, Hh^Fds, Hh, Hh, Rd, Hh, Wwf, Ww, Rd, Rd, Rd, Rd, Rd, Rd, Re, Gll^Fp, Re, Ss, Gll, Gll, Ss, Sm^Tf, Ss, Ss, Rb, Ss, Ss, Ss, Ss, Ss, Gll, Rd, Gg, Rd, 3 Rd, Gs, Gs, Gg, Gg, Ce, Rd, Rd, Rd
Dd, Rd, Rd, Gd, Gd, Gd, Gs, Gs, Gs, Gg, Gg, Gg, Gg, Ww, Ww, Ww, Rd, Rd, Gs, Gs, Gg, Gs^Fds, Ww, Ww, Ww, Hh, Ww, Hh, Wwr, Hh, Ww, Hh, Wwr, Gs, Gs, Gs, Hh, Gll^Fp, Gll^Fp, Gll^Fp, Gll^Fp, Gll^Fp, Ss, Gll, Gll^Em, Ss, Sm^Tf, Sm^Tf, Rb^Emf, Re, Re, Ss, Re, Re, Re, Re, Gg, Rd, Gg, Gs, Gg, Gs, Gs, Gg, Ce, 2 Ke, Re, Gg
Dd, Dd, Rd, Gd, Gd, Dd, Cd^Vda, Dd, Gd, Gg, Gg, Gg, Rd, Gg, Ww^Bw/r, Ww^Bw/, Ds, Gg, Ds, Gg, Ds, Ww, Wo, Wo, Wo, Ww, Ww, Ww, Ww, Ww, Hh, Ww, Hh, Hh, Hh, Hh, Hh^Fp, Hh^Fp, Hh^Fp, Hh^Fp, Hh^Fp, Gs, Gs, Gll^Em, Ss, Ss, Ss, Rb^Vhs, Rb^Em, Rb^Edt, Re^Edt, Re, Gll, Gll, Ss, Gll, Gs^Fms, Gg, Gg, Gg, Gg, Gg, Gg, Gg, Gg, Ce, Gg, Gg
Gd, Gd, Gd, Rd, Rd, Rd, Rd, Dd, Rd, Rd, Rd, Rd, Gg, Rd, Gg, Ww, Ww, Ds, Ww, Ds, Ww, Ww, Ww, Ww, Ww, Wo, Ww, Ww, Ww, Wwt, Wwr, Hh, Hh, Hh, Gs, Hh, Gs^Vc, Hh^Fp, Hh, Hh, Gs, Gs, Gll, Gll, Ss, Ss, Ss, Ss, Ss, Ss, Sm^Tf, Gll, Ss, Gll, Gll^Em, Gg, Gll^Fp, Gs^Fms, Gs^Fms, Gs^Fms, Gll^Fp, Gg, Gg^Vhs, Gg, Gg, Gg, Gg, Gg
Dd, Dd, Dd, Gd, Gd, Gd, Gs, Rd, Gs, Gs, Gs, Gg, Gg, Gg, Gs^Fms, Ww, Ww, Ww, Ww, Ww, Gs^Fds, Gs^Fds, Gs^Fds, Ww, Gs^Fds, Ww, Hh, Ww, Hh, Hh, Wwt, Hh, Hh, Hh, Hh, Gs, Gs, Hh, Gg, Hh, Hh, Gs, Ss, Gll, Gll, Gll, Gll, Gll, Gll, Ss, Ss, Ss, Gll^Vhs, Gll^Em, Gll^Em, Ss, Ss, Gs^Fms, Gs^Fms, Gs^Fms, Ss, Ss, Ss^Ewl, Ss, Gg, Gg, Gg, Gg
Hd, Dd, Dd, Gd, Dd, Gd, Gd, Gs, Gs, Gg, Gg, Gg, Gs^Fds, Gs^Fds, Gs^Fms, Gs^Fds, Gg, Gs^Fms, Gs^Fms, Gs^Fms, Gs^Fms, Gs^Fms, Gs^Fms, Gs^Fds, Ww, Ww, Hh, Hh, Hh, Wwt, Hh, Hh, Hh, Hh, Hh, Gs, Hh, Gs, Gs, Gg, Gg, Gg, Ss, Ss, Gll, Gll, Ss, Gll^Em, Gll, Gll, Gll, Gll^Em, Gll, Ss, Ss, Ss, Ss, Gll^Fp, Gll^Fp, Gll^Fp, Gll^Fp, Ss, Ss^Ewl, Ss^Ewl, Ss, Gg, Gg, Gg
Hd, Dd^Edpp, Dd, Dd, Dd, Gd, Gd, Gd, Gs, Gg, Gg, Gg, Gg, Gg, Gg, Gg, Gs^Fds, Gs^Fms, Gs^Fds, Gs^Fds, Gs^Fms, Gs^Fds, Hh^Fds, Gs^Fds, Hh^Fds, Hh^Fds, Hh^Fds, Hh^Fds, Hh^Fds, Wwrg, Ww, Hh, Hh, Hh, Hh, Hh, Hh, Gg, Gg, Gg, Gg, Gg, Gll, Gll, Gll, Ss, Ss, Ss, Ss, Gll, Ss, Gll, Ss, Ss, Ss, Ss, Ss, Ss, Gll^Fp, Gll^Fp, Gll^Fp, Gll^Fp, Gll^Fp, Ss, Ss, Gg, Gg, Gg
Hd, Hd, Hd, Dd, Dd, Dd, Dd, Gd, Gg, Gg, Gg, Gg, Gg, Gg, Gg, Gg, Gg, Gg, Gg, Gs^Fds, Gg, Gg, Gg, Hh^Fds, Gg, Hh, Gg, Hh, Gg, Hh, Ww, Hh, Gg, Hh, Gg, Hh, Gg, Gg, Gg, Gg, Gg, Gg, Gg, Ss, Ss, Ss, Ss, Ss, Ss, Ss, Ss, Ss, Gg, Ss, Gg, Ss, Gg, Ss, Gll^Fp, Gll^Fp, Gll^Fp, Gll^Fp, Gll^Fp, Ss, Ss, Ss, Gg, Gg
