Aa^Fda, Aa^Fda, Aa^Fda, Aa^Fda, Aa^Fda, Aa^Fda, Aa^Fda, Aa, Rb, Aa^Fda, Aa^Fda, Aa^Fda, Aa^Fda, Aa^Fda, Aa^Fda, Aa^Fda, Aa^Fda, Aa, Aa, Ai, Ai, Ai, Aa, Ai, Aa, Aa^Fpa, Aa^Fpa, Aa^Fpa, Aa^Fpa, Aa^Fpa, Aa^Fpa, Aa^Fpa, Aa^Fpa, Aa^Fpa, Aa^Fpa, Aa^Fpa, Aa^Fpa, Aa^Fpa
Aa^Fda, Aa^Fda, Aa^Fda, Aa^Fda, Aa^Fda, Aa^Fda, Aa^Fda, Aa, Rb, Aa^Fda, Aa^Fda, Aa^Fda, Aa^Fda, Aa^Fda, Aa^Fda, Aa^Fda, Aa^Fda, Aa, Aa, Aa, Ai, Aa, Aa, Aa, Aa, Aa^Fpa, Aa^Fpa, Aa^Fpa, Aa^Fpa, Aa^Fpa, Aa^Fpa, Aa^Fpa, Aa^Fpa, Aa^Fpa, Aa^Fpa, Aa^Fpa, Aa^Fpa, Aa^Fpa
Aa^Fda, Aa^Fda, Aa^Fda, Aa^Fda, Aa^Fda, Aa^Fda, Aa^Fda, Aa, Aa, Rb, Aa, Aa, Aa, Aa^Fda, Aa^Fda, Aa^Fda, Aa^Fda, Aa, Aa, Aa, Aa, Ai, Ai, Aa, Aa, Aa^Fpa, Aa^Fpa, Aa^Fpa, Aa^Fpa, Aa^Fpa, Aa^Fpa, Aa^Fpa, Aa^Fpa, Aa^Fpa, Aa^Fpa, Aa^Fpa, Aa^Fpa, Aa^Fpa
Aa^Fda, Aa^Fda, Aa^Fda, Aa^Fda, Aa^Fda, Aa^Fda, Aa^Fda, Aa^Fda, Aa, Rb, Rb, 2 Ke, Ce, Aa, Aa^Fda, Aa^Fda, Aa, Aa, Aa, Aa, Aa, Aa, Ai, Aa, Aa^Fpa, Aa^Fpa, Aa^Fpa, Aa^Fpa, Aa^Fpa, Aa^Fpa, Aa^Fpa, Aa^Fpa, Aa^Fpa, Aa^Fpa, Aa^Fpa, Aa^Fpa, Aa^Fpa, Aa^Fpa
Aa^Fda, Aa^Fda, Aa^Fda, Aa^Fda, Aa^Fda, Aa^Fda, Aa^Fda, Aa, 1 Ke, Rb, Rb, Ce, Aa, Aa, Aa, Aa, Aa, Aa, Aa, Aa, Aa, Ai, Aa^Fpa, Aa^Fpa, Aa^Fpa, Aa^Fpa, Aa^Fpa, Aa^Fpa, Aa^Fpa, Aa^Fpa, Aa^Fpa, Aa^Fpa, Aa^Fpa, Aa^Fpa, Aa^Fpa, Aa^Fpa, Aa^Fpa, Aa^Fpa
Aa^Fda, Aa^Fda, Aa^Fda, Aa^Fda, Aa^Fda, Aa^Fda, Aa^Fda, Aa, Ce, Ce, Rb, Rb, Rb, Aa, Ai, Ai, Ai, Aa, Ai, Ai, Ai, Ai, Aa^Fpa, Aa^Fpa, Aa^Fpa, Aa^Fpa, Aa^Fpa, Aa^Fpa, Aa^Fpa, Aa^Fpa, Aa^Fpa, Aa^Fpa, Aa^Fpa, Aa^Fpa, Aa^Fpa, Aa^Fpa, Aa^Fpa, Aa^Fpa
Aa, Aa^Fda, Aa^Fda, Aa^Fda, Aa^Fda, Aa^Fda, Aa, Aa, Aa, Aa, Aa, Rb, Rb^Esa, Aa, Ai, Aa, Aa, Ai^Esa, Aa, Aa, Aa, Aa^Fpa, Aa^Fpa, Aa^Fpa, Aa^Fpa, Aa^Fpa, Aa^Fpa, Aa^Fpa, Aa^Fpa, Aa^Fpa, Aa^Fpa, Aa^Fpa, Aa^Fpa, Aa^Fpa, Aa^Fpa, Aa^Fpa, Aa^Fpa, Aa^Fpa
Ai, Aa, Ai, Aa^Fda, Aa, Aa^Fda, Aa, Aa, Ai^Esa, Ai, Ai, Rb^Esa, Wwf, Ai, Aa, Aa, Aa, Aa, Aa, Aa, Ce, Aa^Fpa, Aa^Fpa, Aa^Fpa, Aa^Fpa, Aa^Fpa, Aa^Fpa, Aa^Fpa, Aa^Fpa, Aa^Fpa, Aa^Fpa, Aa^Fpa, Aa^Fpa, Aa^Fpa, Aa^Fpa, Aa^Fpa, Aa^Fpa, Aa^Fpa
Aa^Fda, Ai, Aa^Fda, Ai, Ai, Aa, Aa, Aa, Ai, Aa, Aa, Ai, Aa, Rb^Esa, Rb, Aa, Gd, Aa, Gd, Ce^Ebn, Rb, Cea, Aa^Fpa, Aa^Fpa, Aa^Fpa, Aa^Fpa, Aa^Fpa, Aa^Fpa, Aa, Aa^Fpa, Aa^Fpa, Aa^Fpa, Aa^Fpa, Aa^Fpa, Aa^Fpa, Aa^Fpa, Aa^Fpa, Aa^Fpa
Aa^Fda, Aa^Fda, Aa^Fda, Aa, Ai^Esa, Aa, Aa, Aa, Ai, Aa, Aa, Aa, Aa, Aa, Ce, Ce, Gd, Gd, Aa, Gd, Rb, Gll, Gll, Aa^Fpa, Aa^Fpa, Aa^Fpa, Gd^Vl, Aa^Fpa, Aa^Fpa, Aa, Aa^Fpa, Aa^Fpa, Aa, Aa^Fpa, Aa^Fpa, Aa^Fpa, Aa^Fpa, Aa^Fpa
Aa^Fda, Aa^Fda, Aa^Fda, Aa^Fda, Aa^Fda, Ai, Ai, Wwg, Aa, Aa, Aa, Aa, Gd, Gd, Aa, 3 Ke, Gd, Aa, Aa^Fpa, Rb, Gd, Rb^Vl, Rb, Gll, Gll, Gll, Gd, Ce, Ce^Eb, Aa^Fpa, Aa, Aa^Fpa, Aa^Fpa, Aa^Fpa, Aa^Fpa, Aa^Fpa, Aa^Fpa, Aa^Fpa
Aa^Fda, Aa^Fda, Aa^Fda, Aa^Fda, Aa^Fda, Aa^Fda, Ai, Aa, Aa, Aa, Cea^Eb, Gd, Aa, Aa^Fda, Aa, Rr, Gd, Aa, Gd, Rb, Rb, Gd, Rb, Gd, Gd, Gd, Aa, Gd, Cea, Aa, Aa, Aa^Fpa, Aa^Fpa, Aa^Fpa, Aa^Fpa, Aa^Fpa, Aa^Fpa, Aa^Fma
Aa^Fda, Aa^Fda, Aa^Fda, Aa^Fda, Aa^Fda, Ai, Aa, Aa, Aa, Aa, Aa, Gd, Aa, Aa^Fda, Rr, Rr, Rr, Gd, Cea, Rb, Rrc, Gd^Dr, Cea, Rb, Rb, Gd, Aa, Gd, Gd, Gll, Aa^Fpa, Aa^Fpa, Aa^Fpa, Aa^Fpa, Aa^Fpa, Aa^Fpa, Aa^Fpa, Aa^Fma
Aa^Fda, Aa^Fda, Aa^Fda, Aa^Fda, Ai, Ai, Aa, Aa, Cea, Aa, Gd, Gd, Rr, Rb, Gd, Gd, Rr, Cea^Ebn, Rr^Esa, Rrc, Rrc, Rr, Rr, Cea^Ebn, Rb, Gd, Gd, Gd, Rb, Gd^Vl, Aa, Aa, Aa, Aa^Fpa, Aa^Fpa, Aa^Fpa, Aa^Fpa, Aa^Fma
Aa^Fda, Aa^Fda, Aa^Fda, Ai, Aa, Aa^Fda, Aa^Fda, Aa, Cea^Ebn, Gd, Rb^Vl, Gd, Rr, Gd, Aa, Gd, Re, Rr, Rrc, Rrc^Vc, Rrc, Rrc, Rrc^Vc, Rr, Rb, Gd^Vl, Rb, Rb, Gd, Rb^Esa, Rb^Esa, Aa, Rb^Esa, Rb^Esa, Rb^Esa, Rb^Edt, Rb^Esa, Rb
Aa^Fda, Aa^Fda, Aa, Ai, Ai, Aa^Fda, Aa^Fda, Aa, Cea, Gd, Rr, Rb, Gd, Rb, Rb, Gd, Gd^Dr, Rr, Rrc^Vc, Rrc, Rrc, Rrc, Rrc, Rr, Aa^Fpa, Rb, Gd, Gd, Gd, Aa, Rb^Esa, Rb^Esa, Aa^Esa, Aa, Aa, Aa^Fpa, Aa^Fpa, Aa^Fpa
Aa, Aa, Aa, Aa, Aa, Ai, Aa, Aa, Gd, Gd, Rr, Gd, Gd^Wm, Gd, Aa^Fda, Rb, Rb, Rr, Rrc, Rrc, Rrc, Rrc^Vc, Rrc, Rr, Rr, Aa, Aa, Rb, Gd, Rb^Esa, Cea, Aa^Esa, Aa, Aa, Aa, Aa^Edt, Aa^Edt, Aa^Fpa
Aa, Aa, Aa, Aa, Ai, Ai, Aa, Aa, Gd, Rb, Gd, Gd, Gd, Gd, Gd, Aa^Fda, Gd, Cea^Ebn, Cea, Rr, Rr, Rrc, Cea, Cea^Ebn, Aa^Fpa, Rr, Rr, Gd, Rr, Cea, 4 Ke, Aa, Aa^Fpa, Aa, Aa^Edt, Aa^Edt, Aa^Fpa, Aa^Fpa
Aa, Aa, Aa, Ai, Aa, Aa, Aa, Aa, Gd, Rr, Rb, Aa^Fda, Aa^Fda, Gd, Aa^Fda, Gd, Gd, Aa, Gd, Aa, Aa, Rb, Gd, Aa^Fpa, Gd, Gd, Rb, Rb^Vl, Gd, Cea, Aa, Aa, Aa^Fpa, Aa^Fpa, Aa^Fpa, Aa^Fpa, Aa^Fpa, Aa^Fpa
Aa, Aa, Aa, Ai, Aa, Aa, Aa, Gd, Rb, Cea, Cea, Rb, Rb, Aa^Fda, Aa^Fda, Aa^Fda, Gd, Gd, Gd, Aa, Gd, Rb, Gd, Gd, Aa^Feta, Rb, Rb, Aa, Gd, Gd, Aa, Aa^Fpa, Aa^Fpa, Aa^Fpa, Aa^Fpa, Aa^Fpa, Aa^Fpa, Aa^Fpa
Aa, Aa, Aa, Ai, Ai, Aa, Aa, Aa, Aa, 5 Ke, Cea, Aa, Aa, Rb, Rb, Rb, Rb, Gd, Gd, Gd, Gd, Rb, Aa, Gd, Gd, Gd, Aa, Rb, Gd, Aa, Aa^Fpa, Aa^Fpa, Aa^Fpa, Aa^Fpa, Aa^Fpa, Aa^Fpa, Aa^Fpa, Aa^Fpa
Aa, Ha, Ha, Aa, Ai, Aa, Aa, Aa, Aa, Aa, Ha, Aa, Ha, Rb, Aa, Aa, Cea, Rb, Rb, Rb, Rb, Rb, Gd, Aa, Gd, Gd, Gd, Rb, Ce, Aa, Aa^Fpa, Aa^Fpa, Aa^Fpa, Aa^Fpa, Aa^Fpa, Aa^Fpa, Aa^Fpa, Aa^Fpa
Aa, Ha, Ha, Ha, Ai, Ha, Aa, Aa, Ha, Ha, Ha, Ha, Ha, Ha, Aa, Aa, Aa, Cea, Cea, Cea^Ebn, Aa, Rb^Vl, Aa, Gd, Aa, Gd, Cea, Ce^Ebn, Aa, Aa, Aa^Fpa, Aa^Fpa, Aa^Fpa, Aa^Fpa, Aa^Fpa, Aa^Fpa, Aa^Fpa, Aa^Fpa
Aa, Ha, Ha, Ha, Ai, Ha, Ha, Ha, Ha, Ha, Ha, Ha, Aa, Aa, Aa, Aa, Aa, Aa, Aa, Aa, Aa, Aa, Aa, Cea, Cea^Ebn, Aa, Aa, Aa, Aa^Fpa, Aa^Fpa, Aa^Fpa, Aa^Fpa, Aa^Fpa, Aa^Fpa, Aa^Fpa, Aa^Fpa, Aa^Fpa, Aa^Fpa
Aa, Ha, Ha, Ai, Ai, Ha, Ha, Ha, Ha, Ha, Ha, Aa, Aa, Aa, Aa, Aa, Aa, Aa, Aa, Aa, Aa, Aa, Aa, Aa, Aa, Aa, Aa, Aa, Aa^Fpa, Aa^Fpa, Aa^Fpa, Aa^Fpa, Aa^Fpa, Aa^Fpa, Aa^Fpa, Aa^Fpa, Aa^Fpa, Aa
Aa, Ha, Ha, Ha, Ha, Ha, Ha, Ha, Ha, Ha, Ha, Aa, Aa, Aa, Aa, Aa, Aa, Aa, Aa, Aa, Aa, Aa, Aa, Aa, Aa, Aa, Aa, Aa, Aa^Fpa, Aa^Fpa, Aa^Fpa, Aa^Fpa, Aa^Fpa, Aa^Fpa, Aa^Fpa, Aa^Fpa, Aa^Fpa, Aa
Aa, Ha, Aa, Ha, Aa, Ha, Aa, Ha, Aa, Ha, Aa, Aa, Aa, Aa, Aa, Aa, Aa, Aa, Aa, Aa, Aa, Aa, Aa, Aa, Aa, Aa, Aa^Fpa, Aa^Fpa, Aa^Fpa, Aa^Fpa, Aa^Fpa, Aa^Fpa, Aa^Fpa, Aa^Fpa, Aa^Fpa, Aa^Fpa, Aa^Fpa, Aa^Fpa
