Aa, Aa, Aa^Fda, Aa, Aa^Fda, Aa^Fda, Aa, Aa, Rb, Gd, Aa, Aa, Aa^Fda, Aa, Aa, Aa, Aa, Aa, Aa, Aa, Ai, Ai, Aa, Aa, Aa, Aa^Fpa, Aa^Fpa, Aa^Fpa, Aa, Aa^Fpa, Aa^Fpa, Aa^Fpa, Ss, Ss, Ss, Sm, Sm, Ss
Aa, Aa, Aa^Fda, Aa^Fma, Aa^Fda, Aa, Aa, Gd, Rb, Aa, Aa, Aa^Fda, Aa^Fma, Aa, Aa^Fda, Aa, Aa, Aa, Aa, Ai, Ai, Aa, Sm, Sm, Ss, Aa^Fpa, Gll, Aa^Fpa, Sm, Aa, Aa^Fpa, Aa, Aa^Fpa, Ss, Sm, Sm, Sm, Sm
Aa, Aa, Aa, Aa, Aa, Gd, Gd, Gd, Gd, Rb, Gd, Gd, Aa^Fda, Aa^Fma, Aa^Fda, Aa, Aa, Aa, Aa, Aa, Ai, Ai, Ai, Sm, Ss, Gll, Aa^Fpa, Aa^Fpa, Sm, Aa, Aa^Fpa, Gll^Em, Sm, Gll, Aa^Fpa, Sm, Aa^Fpa, Sm
Aa^Fda, Aa, Aa^Fma, Aa, Aa^Fma, Aa, Gd, Gd, Aa, Rb, Rb, 2 Ke, Ce, Aa, Aa, Aa, Gd, Aa, Aa, Sm, Wwg, Wwg, Ai, Sm, Rb, Rb, Aa^Fpa, Gll, Sm, Ss, Ss, Ss, Sm, Gll^Em, Sm, Sm, Sm, Sm
Aa^Fda, Aa^Fma, Aa, Aa, Aa, Aa, Gd, Aa, 1 Ke, Rb, Rb, Ce, Gd, Aa, Gd, Aa, Gd, Gd, Sm, Sm, Wwg, Ai, Aa, Aa^Fpa, Aa^Fpa, Aa^Fpa, Gll, Ss, Aa^Fpa, Sm, Aa^Fpa, Aa^Vla, Sm, Ss, Aa^Fpa, Aa^Fpa, Sm, Ss
Aa^Fda, Aa^Fda, Aa^Fda, Aa, Aa, Aa, Aa, Aa, Ce, Ce, Gd, Rb, Rb, Gd, Ai, Ai, Ai, Ai, Ai, Wwg, Ai, Ai, Aa, Aa^Fpa, Aa^Fpa, Gll, Aa^Fpa, Gll^Em, Aa, Aa^Fpa, Gll, Gll^Em, Gll^Em, Ss, Ss, Sm, Aa^Fpa, Aa^Fpa
Aa^Fda, Aa^Fda, Gd, Gd, Gd, Aa^Fda, Aa^Fma, Aa^Fda, Aa, Gd, Gd, Rb, Rb, Gd, Ai, Aa, Aa, Ai, Aa, Aa, Aa, Aa^Fpa, Aa^Fpa, Aa^Fpa, Aa^Fpa, Aa^Fpa, Aa^Fpa, Aa, Gll^Em, Sm, Aa^Fpa, Aa^Fpa, Sm, Sm, Sm, Sm, Aa^Fpa, Aa^Fpa
Ai, Aa^Fda, Ai, Gd, Gd, Aa, Aa^Fda, Aa^Fda, Ai, Ai, Ai, Rb, Wwf^Es, Wwf^Es, Aa, Gd, Gd, Aa, Gd, Aa, Cea, Aa^Fpa, Aa^Fpa, Rb, Aa, Aa, Aa^Fpa, Gll, Rb, Sm, Sm, Aa^Fpa, Sm, Ss, Gll^Em, Aa^Fpa, Aa^Fpa, Aa^Fpa
Aa^Fda, Ai, Aa^Fda, Ai, Ai, Aa, Gd, Gll, Ai, Gll, Aa, Ai, Aa, Rb, Rb, Gd, Gd, Aa, Rb^Es, Cea, Gd, Cea, Aa, Rb, Aa, Aa^Fpa, Rb, Rb^Es, Rb^Es, Ss, Aa, Aa, Aa^Fpa, Gll, Aa^Fpa, Aa^Fpa, Aa^Fpa, Aa^Fpa
Aa^Fda, Aa^Fda, Aa^Fda, Aa^Fma, Ai, Aa, Gll, Gll, Wwg, Gll, Gll, Gll, Aa, Aa, Cea, Cea, Rb, Rb^Es, Aa, Rb^Edt, Gd, Gd, Gd, Gd, Gd^Vha, Rb, Gd, Rb^Es, Aa, Rb, Aa, Aa^Fpa, Aa, Aa^Fpa, Aa^Fpa, Aa^Vla, Aa^Fpa, Aa^Fpa
Aa^Fma, Aa^Fma, Aa^Fma, Aa^Fma, Aa^Fda, Ai, Ai, Wwg, Aa, Aa, Gll, Aa, Gll, Gll, Aa, 3 Kea, Rb, Aa, Aa, Rb^Edt, Re, Rb^Vl, Re, Rb, Re, Gll, Gd, Cea, Cea, Aa, Gd, Aa^Fpa, Aa^Fpa, Aa^Fpa, Aa^Fpa, Aa^Fpa, Aa^Fpa, Aa^Fpa
Aa^Fma, Aa^Fda, Aa^Fda, Aa^Fma, Aa^Fma, Aa^Fda, Ai, Aa, Aa, Gll, Cea, Cea, Aa, Aa, Aa, Rb, Gd, Aa, Gd, Aa, Gd^Wm, Re, Gll, Gll, Gll, Rb, Aa, Gd, Cea, Aa, Gd, Aa^Fpa, Aa^Fpa, Aa^Fpa, Aa^Fpa, Aa, Aa, Aa^Fma
Aa^Fda, Aa^Fma, Aa^Fma, Aa^Fda, Aa^Fda, Ai, Gd, Aa, Aa, Aa, Aa, Cea, Aa^Fma, Aa^Fma, Gd, Re, Gd, Gd, Cea, Gd, Rb, Gll, Cea, Gll, Aa, Rb, Aa, Gd, Gll, Gll, Aa^Fpa, Aa^Fpa, Aa^Fpa, Aa^Fpa, Aa^Fpa, Gd, Aa^Fpa, Aa^Fma
Aa^Fda, Aa^Fma, Aa^Fma, Aa^Fda, Ai, Ai, Gd, Gd, Cea, Aa, Gll, Gll, Gd, Gd, Rb, Re, Rb, Cea^Ebn, Rb, Rb^Edt, Rb, Aa, Rb, Cea^Ebn, Aa, Rb, Rb, Gd, Gd, Gll^Vla, Aa, Gd, Aa, Aa^Fpa, Gd, Gd, Gd, Aa
Aa^Fma, Aa^Fma, Aa^Fda, Ai, Gd, Gd, Aa^Fda, Gd, Cea, Aa, Rb^Vha, Gll, Re^Edt, Rb, Rb^Vl, Aa, Gd, Rb, Aa, Rb^Vc, Rp, Rb, Rb^Vc, Aa, Rb, Gd^Vl, Rb, Cea, Gll, Gll, Rb, Aa, Rb, Rb, Rb, Rb, Rb, Rb
Aa^Fda, Aa^Fda, Aa, Ai, Ai, Aa^Fda, Aa^Fda, Gd, Cea, Gd, Gd, Re, Rb^Es, Gll, Gd, Aa, Gd, Aa, Rb^Vc, Rp, Rp, Rp, Rb, Rb^Edt, Aa, Rb, Aa, Rb, Rb^Es, Rb^Es, Rb^Es, Rb, Aa, Gd, Aa, Aa, Aa, Aa
Aa, Aa, Gd, Aa, Aa, Ai, Aa, Aa, Cea, Gd, Re, Re^Es, Rb^Es, Cea, Aa, Gd, Aa, Rb, Rb^Edt, Rb^Edt, Rb, Rb^Vc, Aa, Rb^Edt, Gd, Aa, Aa, Gd, Rb^Es, Gll, Cea, Aa, Aa, Gd, Gd, Aa, Aa^Fpa, Aa^Fpa
Aa, Aa, Gd, Gd, Ai, Ai, Aa, Aa, Cea, Aa, Re, Gll, Aa, Gll, Gd, Aa, Aa, Cea^Ebn, Cea, Aa, Rb^Edt, Rb, Cea, Cea^Ebn, Aa, Aa, Gd, Gd^Vl, Rb, Cea, 4 Kea, Aa, Aa, Aa, Aa, Aa, Aa^Fpa, Aa^Fpa
Aa, Gd, Aa, Ai, Aa, Aa, Aa, Aa, Gll, Gll, Rb, Aa, Aa, Gll, Aa^Fma, Gd, Aa^Fma, Aa, Gll, Aa^Fma, Aa, Rb, Gd, Aa, Aa, Gd, Re, Re, Gd, Cea, Aa, Gd, Gd, Aa, Aa, Aa^Fpa, Aa^Fpa, Aa^Fpa
Aa, Aa, Aa, Ai, Aa, Gd, Gd, Gll, Rb, Cea, Cea, Rb, Rb^Es, Aa, Aa, Aa^Fma, Aa, Gll, Rb, Aa, Gll, Re, Gd, Aa, Aa, Gd, Re, Gd^Wm, Aa, Gd, Aa, Gd, Rb, Aa, Aa, Aa, Aa^Fpa, Aa^Fpa
Ha, Aa, Ha, Ai, Ai, Gd, Gd, Aa, Aa, 5 Kea, Cea, Aa, Rb^Edt, Rb^Es, Rb, Re, Re, Re, Aa, Rb, Rb^Vla, Re, Aa, Gd, Gd^Vl, Re, Gd, Aa, Cea, Cea, Aa, Rb, Rb, Aa^Vha, Aa^Edt, Aa^Fpa, Aa, Aa^Fpa
Ha, Ha, Ha, Aa, Ai, Gd, Ai, Gd, Ai, Aa, Ha, Aa, Ha, Aa^Vha, Gd, Gd, Cea, Aa^Fma, Aa^Fma, Gll, Rb^Es, Re^Es, Rb^Es, Aa, Rb^Es, Rb, Gd, Gd, Cea, Aa, Aa, Aa^Edt, Aa^Edt, Rb, Rb, Aa^Edt, Ha, Aa
Ms, Ms, Ha, Ha, Ai, Ai, Ai, Ai, Ha, Ha, Ms, Ha, Ha, Ha, Ha, Aa, Rb, Cea, Cea, Cea, Cea, Rb^Es, Cea, Rb^Es, Cea, Gd, Cea, Cea, Rb, Aa, Gd, Gd, Rb, Rb, Aa^Edt, Aa^Edt, Ha, Ha
Ha, Ha, Ai, Wog, Wog, Wog, Ai, Ai, Ha, Ha, Ha, Ms, Ms, Ha, Gd, Aa, Rb, Aa, Aa, Aa, Aa, Cea, Aa, Cea, Aa, Cea, Rb, Rb, Aa, Aa, Gd^Edt, Rb, Aa, Gd, Aa, Ha, Ha, Ha
Ai, Ha, Ai, Ai, Wog, Wog, Wog, Wog, Ai, Ai, Ha, Ms, Ha, Ha, Gd^Edt, Rb, Rb^Edt, Gd, Rb, Gd, Aa, Aa, Aa, Aa, Aa, Aa, Aa, Rb, Rb^Edt, Aa, Aa^Edt, Aa, Aa^Fpa, Aa^Fpa, Aa^Fpa, Ha^Fpa, Ha, Ha
Ai, Ai, Ai, Ai, Wog, Wog, Wog, Ai, Ai, Ha, Ai, Ha, Ha, Aa, Aa, Aa^Vha, Rb^Edt, Rb^Edt, Gd^Edt, Aa^Edt, Aa, Aa, Aa, Aa, Gd, Gd, Rb^Edt, Rb^Edt, Rb^Edt, Aa^Vha, Aa, Aa, Aa^Fpa, Aa^Fpa, Ha^Fpa, Ha^Fpa, Ha^Fpa, Ha
Ai, Ai, Ai, Ai, Ai, Wog, Wog, Ai, Ai, Ai, Ai, Ai, Aa, Ha, Gd, Gd, Gd^Edt, Gd^Edt, Aa, Aa, Aa, Aa, Aa, Aa, Aa, Gd, Gd, Gd, Gd, Gd^Edt, Gd, Gd, Gd, Aa^Fpa, Aa^Fpa, Ha^Fpa, Ha^Fpa, Ha^Fpa
